puckman	小精靈 (日版 set 1, Probably Bootleg)	小精靈 (日版 set 1, Probably Bootleg)	Namco
puckmana	小精靈 (日版 set 2)	小精靈 (日版 set 2)	Namco
puckmanf	小精靈 (日版 set 1 with speedup hack)	小精靈 (日版 set 1 with speedup hack)	Namco
pacman	小精靈 (Midway)	小精靈 (Midway)	[Namco] (Midway license)
pacmanf	小精靈 (Midway, with speedup hack)	小精靈 (Midway, with speedup hack)	[Namco] (Midway license)
puckmod	小精靈 (日版 set 3)	小精靈 (日版 set 3)	Namco
pacmod	小精靈 (Midway, harder)	小精靈 (Midway, harder)	[Namco] (Midway license)
newpuc2	小精靈 / Newpuc2	小精靈 / Newpuc2	hack
newpuc2b	小精靈 / Newpuc2 (set 2)	小精靈 / Newpuc2 (set 2)	hack
newpuckx	小精靈 / New Puck-X	小精靈 / New Puck-X	hack
pacheart	小精靈 (Hearts)	小精靈 (Hearts)	hack
hangly	小精靈 / Hangly-Man (set 1)	小精靈 / Hangly-Man (set 1)	hack
hangly2	小精靈 / Hangly-Man (set 2)	小精靈 / Hangly-Man (set 2)	hack
hangly3	小精靈 / Hangly-Man (set 3)	小精靈 / Hangly-Man (set 3)	hack
piranhah	小精靈 / 食人魚 (hack)	小精靈 / 食人魚 (hack)	hack
pacplus	小精靈 Plus	小精靈 Plus	[Namco] (Midway license)
joyman	小精靈 / Joyman	小精靈 / Joyman	hack
piranha	小精靈 / 食人魚	小精靈 / 食人魚	GL (US Billiards License)
piranhao	小精靈 / 食人魚 (older)	小精靈 / 食人魚 (older)	GL (US Billiards License)
mspacman	Ms. 小精靈	Ms. 小精靈	Midway
mspacmnf	Ms. 小精靈 (with speedup hack)	Ms. 小精靈 (with speedup hack)	Midway
mspacmat	Ms. 小精靈 / Ms. Pac Attack	Ms. 小精靈 / Ms. Pac Attack	hack
mspacmab	Ms. 小精靈 (bootleg)	Ms. 小精靈 (bootleg)	bootleg
pacgal	Ms. 小精靈 / Pac-Gal	Ms. 小精靈 / Pac-Gal	hack
mspacpls	Ms. 小精靈 Plus	Ms. 小精靈 Plus	hack
alibaba	阿里巴巴與 40 大盜	阿里巴巴與 40 大盜	Sega
mschamp	Ms. 小精靈冠軍版 / Super Zola Pac Gal	Ms. 小精靈冠軍版 / Super Zola Pac Gal	hack
galaxian	小蜜蜂 (Namco set 1)	小蜜蜂 (Namco set 1)	Namco
galaxiaj	小蜜蜂 (Namco set 2)	小蜜蜂 (Namco set 2)	Namco
galmidw	小蜜蜂 (Midway)	小蜜蜂 (Midway)	[Namco] (Midway license)
galmidwo	小蜜蜂 (Midway, old rev)	小蜜蜂 (Midway, old rev)	[Namco] (Midway license)
superg	小蜜蜂 / 超級小蜜蜂	小蜜蜂 / 超級小蜜蜂	hack
galapx	小蜜蜂 Part X	小蜜蜂 Part X	hack
moonaln	小蜜蜂 / Moon Alien	小蜜蜂 / Moon Alien	[Nichibutsu] (Karateco license)
galap1	小蜜蜂 / 太空入侵者	小蜜蜂 / 太空入侵者	hack
galap4	小蜜蜂 Part 4	小蜜蜂 Part 4	hack
galturbo	小蜜蜂 Turbo	小蜜蜂 Turbo	hack
swarm	小蜜蜂 / 蜂群	小蜜蜂 / 蜂群	hack
zerotime	小蜜蜂 / Zero Time	小蜜蜂 / Zero Time	Petaco S.A.
tst_galx	小蜜蜂 / Galaxian Test ROM	小蜜蜂 / Galaxian Test ROM	Test ROM
uniwars	銀河帝國的反擊 / UniWar S	銀河帝國的反擊 / UniWar S	Irem
gteikoku	銀河帝國的反擊 / Gingateikoku No Gyakushu	銀河帝國的反擊 / Gingateikoku No Gyakushu	Irem
gteikokb	銀河帝國的反擊 / Gingateikoku No Gyakushu (bootleg set 1)	銀河帝國的反擊 / Gingateikoku No Gyakushu (bootleg set 1)	bootleg
gteikob2	銀河帝國的反擊 / Gingateikoku No Gyakushu (bootleg set 2)	銀河帝國的反擊 / Gingateikoku No Gyakushu (bootleg set 2)	bootleg
spacbatt	銀河帝國的反擊 / 太空戰鬥	銀河帝國的反擊 / 太空戰鬥	bootleg
skyraidr	銀河帝國的反擊 / Sky Raiders	銀河帝國的反擊 / Sky Raiders	bootleg
batman2	不死鳥  / 蝙蝠俠 Part 2	不死鳥  / 蝙蝠俠 Part 2	bootleg
pacmanbl	小精靈 (Galaxian hardware)	小精靈 (Galaxian hardware)	bootleg
devilfsg	魔魚 (Galaxian hardware, bootleg?)	魔魚 (Galaxian hardware, bootleg?)	Vision / Artic
zigzag	挖地道 (Galaxian hardware, set 1)	挖地道 (Galaxian hardware, set 1)	LAX
zigzag2	挖地道 (Galaxian hardware, set 2)	挖地道 (Galaxian hardware, set 2)	LAX
moonal2	月球異形 Part 2	月球異形 Part 2	Nichibutsu
moonal2b	月球異形 Part 2 (older version)	月球異形 Part 2 (older version)	Nichibutsu
4in1	樂趣四合一	樂趣四合一	Armenia / Food and Fun
dkongjrm	大金剛 Jr. (Moon Cresta hardware)	大金剛 Jr. (Moon Cresta hardware)	bootleg
atlantis	Atlantis 戰爭 (set 1)	Atlantis 戰爭 (set 1)	Comsoft
atlants2	Atlantis 戰爭 (set 2)	Atlantis 戰爭 (set 2)	Comsoft
ckongs	瘋狂大金剛 (Scramble hardware)	瘋狂大金剛 (Scramble hardware)	bootleg
devilfsh	魔魚	魔魚	Artic
scobra	超級眼鏡蛇	超級眼鏡蛇	Konami
scobras	超級眼鏡蛇 (Stern)	超級眼鏡蛇 (Stern)	[Konami] (Stern license)
scobrase	超級眼鏡蛇 (Sega)	超級眼鏡蛇 (Sega)	[Konami] (Sega license)
scobrab	超級眼鏡蛇 (bootleg)	超級眼鏡蛇 (bootleg)	bootleg
armorcar	裝甲車 (set 1)	裝甲車 (set 1)	Stern
armorca2	裝甲車 (set 2)	裝甲車 (set 2)	Stern
moonwar	月球戰爭	月球戰爭	Stern
moonwara	月球戰爭 (older)	月球戰爭 (older)	Stern
darkplnt	黑暗星球	黑暗星球	Stern
ckong	瘋狂大金剛 (set 1)	瘋狂大金剛 (set 1)	Falcon
ckonga	瘋狂大金剛 (set 2)	瘋狂大金剛 (set 2)	Falcon
ckongjeu	瘋狂大金剛 (Jeutel bootleg)	瘋狂大金剛 (Jeutel bootleg)	bootleg
ckongo	瘋狂大金剛 (Orca bootleg)	瘋狂大金剛 (Orca bootleg)	bootleg
ckongalc	瘋狂大金剛 (Alca bootleg)	瘋狂大金剛 (Alca bootleg)	bootleg
bigkong	瘋狂大金剛 / Big Kong	瘋狂大金剛 / Big Kong	bootleg
monkeyd	瘋狂大金剛 / Monkey Donkey	瘋狂大金剛 / Monkey Donkey	bootleg
yamato	大和號 (美版)	大和號 (美版)	Sega
yamato2	大和號 (世界版?)	大和號 (世界版?)	Sega
swimmer	游泳高手 (set 1)	游泳高手 (set 1)	Tehkan
swimmera	游泳高手  (set 2)	游泳高手  (set 2)	Tehkan
swimmerb	游泳高手  (set 3)	游泳高手  (set 3)	Tehkan
ckongb	瘋狂大金剛 (Alternative levels)	瘋狂大金剛 (Alternative levels)	bootleg
gomoku	五目連珠	五目連珠	Nichibutsu
terracre	火鳳凰 / 神鷹一號 (YM3526 set 1)	火鳳凰 / 神鷹一號 (YM3526 set 1)	Nichibutsu
terracrb	火鳳凰 / 神鷹一號 (YM3526 set 2)	火鳳凰 / 神鷹一號 (YM3526 set 2)	Nichibutsu
terracra	火鳳凰 / 神鷹一號 (YM2203)	火鳳凰 / 神鷹一號 (YM2203)	Nichibutsu
dangar	UFO 變形金剛 (12/1/1986)	UFO 變形金剛 (12/1/1986)	Nichibutsu
dangar2	UFO 變形金剛 (9/26/1986)	UFO 變形金剛 (9/26/1986)	Nichibutsu
dangarb	UFO 變形金剛 (bootleg)	UFO 變形金剛 (bootleg)	bootleg
ninjemak	妖魔忍法帖 (美版)	妖魔忍法帖 (美版)	Nichibutsu
youma	妖魔忍法帖 (日版)	妖魔忍法帖 (日版)	Nichibutsu
kodure	帶子狼 (日版)	帶子狼 (日版)	Nichibutsu
armedf	武裝編隊	武裝編隊	Nichibutsu
hyhoo	對戰問答 HYHOO (日版)	對戰問答 HYHOO (日版)	Nichibutsu
hyhoo2	對戰問答 HYHOO 2 (日版)	對戰問答 HYHOO 2 (日版)	Nichibutsu
crystalg	水晶女孩 (日版 860512)	水晶女孩 (日版 860512)	Nichibutsu
crystal2	水晶女孩 2 (日版 860620)	水晶女孩 2 (日版 860620)	Nichibutsu
citylove	都市之戀 (日版 860908)	都市之戀 (日版 860908)	Nichibutsu
secolove	第二情人 (日版 861201)	第二情人 (日版 861201)	Nichibutsu
housemnq	對家麻濡感 (日版 870217)	對家麻濡感 (日版 870217)	Nichibutsu
housemn2	對家麻濡感 六本木實況編 (日版 870418)	對家麻濡感 六本木實況編 (日版 870418)	Nichibutsu
seiha	制霸 (日版 870725)	制霸 (日版 870725)	Nichibutsu
seiham	制霸 [BET] (日版 870723)	制霸 [BET] (日版 870723)	Nichibutsu
bijokkoy	美女子夢物語 (日版 870925)	美女子夢物語 (日版 870925)	Nichibutsu
iemoto	家元 (日版 871020)	家元 (日版 871020)	Nichibutsu
bijokkog	美女子學園 (日版 880116)	美女子學園 (日版 880116)	Nichibutsu
korinai	麻雀 - 愛玩無罪 (日版 880425)	麻雀 - 愛玩無罪 (日版 880425)	Nichibutsu
kaguya	麻雀 傢具屋公主 [BET] (日版 880521)	麻雀 傢具屋公主 [BET] (日版 880521)	MIKI SYOUJI
otonano	大人麻雀 (日版 880628)	大人麻雀 (日版 880628)	Apple
mjsikaku	麻雀刺客 (日版 880908)	麻雀刺客 (日版 880908)	Nichibutsu
mjsikakb	麻雀刺客 (日版 880722)	麻雀刺客 (日版 880722)	Nichibutsu
mjsikakc	麻雀刺客 (日版 880806)	麻雀刺客 (日版 880806)	Nichibutsu
mjsikakd	麻雀刺客 (日版 880802)	麻雀刺客 (日版 880802)	Nichibutsu
mmsikaku	麻雀刺客 [BET] (日版 880929)	麻雀刺客 [BET] (日版 880929)	Nichibutsu
mjcamera	麻雀 相機小僧 (set 1) (日版 881109)	麻雀 相機小僧 (set 1) (日版 881109)	MIKI SYOUJI
mmcamera	麻雀 相機小僧 / Mahjong Camera Kozou [BET] (日版 890509)	麻雀 相機小僧 / Mahjong Camera Kozou [BET] (日版 890509)	MIKI SYOUJI
msjiken	麻雀 殺人事件 (日版 881017)	麻雀 殺人事件 (日版 881017)	Nichibutsu
hanamomo	麻雀刺客外傳 花之百子組 (日版 881201)	麻雀刺客外傳 花之百子組 (日版 881201)	Nichibutsu
telmahjn	電話麻雀 (日版 890111)	電話麻雀 (日版 890111)	Nichibutsu
taiwanmb	台灣麻雀 [BET] (日版 881208)	台灣麻雀 [BET] (日版 881208)	MIKI SYOUJI
gionbana	祇園花 (日版 890120)	祇園花 (日版 890120)	Nichibutsu
mjfocus	麻雀 聚焦 (日版 890313)	麻雀 聚焦 (日版 890313)	Nichibutsu
mjfocusm	麻雀 聚焦 [BET] (日版 890510)	麻雀 聚焦 [BET] (日版 890510)	Nichibutsu
peepshow	麻雀 聚焦 / 麻雀西洋景 (日版 890404)	麻雀 聚焦 / 麻雀西洋景 (日版 890404)	AC
mgmen89	麻雀 G-MEN'89 (日版 890425)	麻雀 G-MEN'89 (日版 890425)	Nichibutsu
bananadr	麻雀 香蕉之夢 [BET] (日版 891124)	麻雀 香蕉之夢 [BET] (日版 891124)	Digital Soft
mladyhtr	麻雀 小姐獵手 怪盜黑貓連盟編 (日版 900509)	麻雀 小姐獵手 怪盜黑貓連盟編 (日版 900509)	Nichibutsu
chinmoku	麻雀 沉默編隊 (日版 900511)	麻雀 沉默編隊 (日版 900511)	Nichibutsu
maiko	舞妓花 (日版 900802)	舞妓花 (日版 900802)	Nichibutsu
club90s	麻雀俱樂部 90's (set 1) (日版 900919)	麻雀俱樂部 90's (set 1) (日版 900919)	Nichibutsu
club90sa	麻雀俱樂部 90's (set 2) (日版 900919)	麻雀俱樂部 90's (set 2) (日版 900919)	Nichibutsu
hanaoji	花與歐吉桑 [BET] (日版 911209)	花與歐吉桑 [BET] (日版 911209)	Nichibutsu
pstadium	麻雀 驚恐競技場 (日版)	麻雀 驚恐競技場 (日版)	Nichibutsu
triplew1	麻雀 三倍戰爭 (日版)	麻雀 三倍戰爭 (日版)	Nichibutsu
triplew2	麻雀 三倍戰爭 2 (日版)	麻雀 三倍戰爭 2 (日版)	Nichibutsu
ntopstar	藝能界麻雀 (日版)	藝能界麻雀 (日版)	Nichibutsu
mjlstory	麻雀 實驗愛情故事 (日版)	麻雀 實驗愛情故事 (日版)	Nichibutsu
vanilla	麻雀 香草綜合症 (日版)	麻雀 香草綜合症 (日版)	Nichibutsu
finalbny	麻雀 香草綜合症 / 麻雀 最後的兔女郎 [BET] (日版)	麻雀 香草綜合症 / 麻雀 最後的兔女郎 [BET] (日版)	Nichibutsu
qmhayaku	問答 麻雀 早安! (日版)	問答 麻雀 早安! (日版)	Nichibutsu
galkoku	麻雀 女孩的告白 (日版)	麻雀 女孩的告白 (日版)	Nichibutsu/T.R.TEC
hyouban	麻雀 評判娘 [BET] (日版)	麻雀 評判娘 [BET] (日版)	Nichibutsu/T.R.TEC
galkaika	麻雀 如花少女 (日版)	麻雀 如花少女 (日版)	Nichibutsu/T.R.TEC
tokyogal	東京女子圖鑒 (日版)	東京女子圖鑒 (日版)	Nichibutsu
tokimbsj	胸騷美少女 [BET] (日版)	胸騷美少女 [BET] (日版)	Nichibutsu
uchuuai	麻雀 來自宇宙的愛 (日版)	麻雀 來自宇宙的愛 (日版)	Nichibutsu
av2mj1bb	AV2 麻雀 No.1 海灣大橋聖女 (日版)	AV2 麻雀 No.1 海灣大橋聖女 (日版)	MIKI SYOUJI/AV JAPAN
av2mj2rg	AV2 麻雀 No.2 紅粉佳人 (日版)	AV2 麻雀 No.2 紅粉佳人 (日版)	MIKI SYOUJI/AV JAPAN
mjuraden	麻雀 占卜傳說 (日版)	麻雀 占卜傳說 (日版)	Nichibutsu/Yubis
koinomp	麻雀 戀愛的魔力 (日版)	麻雀 戀愛的魔力 (日版)	Nichibutsu
patimono	麻雀 柏青哥物語 (日版)	麻雀 柏青哥物語 (日版)	Nichibutsu
mjanbari	獎章麻雀 認真峇里島 [BET] (日版)	獎章麻雀 認真峇里島 [BET] (日版)	Nichibutsu/Yubis/AV JAPAN
gal10ren	麻將十連莊 (日版)	麻將十連莊 (日版)	FUJIC
renaiclb	麻雀戀愛俱樂部 (日版)	麻雀戀愛俱樂部 (日版)	FUJIC
mjlaman	麻雀情緣 (日版)	麻雀情緣 (日版)	Nichibutsu/AV JAPAN
mkeibaou	麻雀 競馬王 (日版)	麻雀 競馬王 (日版)	Nichibutsu
pachiten	獎章麻雀 水果盤天國 [BET]  (日版)	獎章麻雀 水果盤天國 [BET]  (日版)	Nichibutsu/MIKI SYOUJI/AV JAPAN
sailorws	麻雀 Triple Wars 番外編 水手之戰 (日版)	麻雀 Triple Wars 番外編 水手之戰 (日版)	Nichibutsu
sailorwa	麻雀 Triple Wars 番外編 水手之戰 (日版) (set 2)	麻雀 Triple Wars 番外編 水手之戰 (日版) (set 2)	Nichibutsu
sailorwr	麻雀 Triple Wars 番外編 水手之戰-R [BET] (日版)	麻雀 Triple Wars 番外編 水手之戰-R [BET] (日版)	Nichibutsu
psailor1	美少女雀士漂亮水手 18 禁 (日版)	美少女雀士漂亮水手 18 禁 (日版)	SPHINX
psailor2	美少女雀士漂亮水手 2 (日版)	美少女雀士漂亮水手 2 (日版)	SPHINX
otatidai	Disco 麻雀 (日版)	Disco 麻雀 (日版)	SPHINX
ngpgal	熱血女孩 (日版)	熱血女孩 (日版)	Nichibutsu
mjgottsu	麻雀 身臨其境! (日版)	麻雀 身臨其境! (日版)	Nichibutsu
bakuhatu	麻雀 爆發純情傳 (日版)	麻雀 爆發純情傳 (日版)	Nichibutsu
cmehyou	麻雀 巡回女豹 (日版)	麻雀 巡回女豹 (日版)	Nichibutsu/Kawakusu
mmehyou	獎章麻雀 巡回女豹 [BET]  (日版)	獎章麻雀 巡回女豹 [BET]  (日版)	Nichibutsu/Kawakusu
mjkoiura	麻雀 戀愛占卜 (日版)	麻雀 戀愛占卜 (日版)	Nichibutsu
mkoiuraa	麻雀 戀愛占卜 (set 2) (日版)	麻雀 戀愛占卜 (set 2) (日版)	Nichibutsu
imekura	瘋狂麻雀 (日版)	瘋狂麻雀 (日版)	SPHINX/AV JAPAN
mscoutm	麻雀 偵察員 潛入!! AV 撮影現場 (日版)	麻雀 偵察員 潛入!! AV 撮影現場 (日版)	SPHINX/AV JAPAN
mjegolf	麻雀 美女高爾夫 (日版)	麻雀 美女高爾夫 (日版)	FUJIC/AV JAPAN
niyanpai	娘牌 (日版)	娘牌 (日版)	Nichibutsu
phoenix	不死鳥 (Amstar)	不死鳥 (Amstar)	Amstar
phoenixa	不死鳥 (Centuri)	不死鳥 (Centuri)	Amstar (Centuri license)
phoenixt	不死鳥 (Taito)	不死鳥 (Taito)	Taito
phoenix3	不死鳥 (T.P.N.)	不死鳥 (T.P.N.)	bootleg
phoenixc	不死鳥 (IRECSA, G.G.I Corp)	不死鳥 (IRECSA, G.G.I Corp)	bootleg?
condor	不死鳥 / Condor	不死鳥 / Condor	Sidam
falcon	不死鳥 / 獵鷹 (bootleg set 1)	不死鳥 / 獵鷹 (bootleg set 1)	bootleg
vautour	不死鳥 / Vautour (set 1 - Jeutel 法國版)	不死鳥 / Vautour (set 1 - Jeutel 法國版)	bootleg
vautour2	不死鳥 / Vautour (set 2)	不死鳥 / Vautour (set 2)	bootleg
griffon	不死鳥 / Griffon	不死鳥 / Griffon	Videotron
kaitei	海底探寶	海底探寶	Namco
kaiteik	海底探寶 (K'K-Tokki)	海底探寶 (K'K-Tokki)	K.K. Tokki
tankbatt	超級坦克	超級坦克	Namco
rallyx	拉力賽 X	拉力賽 X	Namco
rallyxm	拉力賽 X (Midway)	拉力賽 X (Midway)	[Namco] (Midway license)
nrallyx	新拉力賽 X	新拉力賽 X	Namco
galaga	大蜜蜂 (Namco rev. B)	大蜜蜂 (Namco rev. B)	Namco
galagao	大蜜蜂 (Namco)	大蜜蜂 (Namco)	Namco
galagamw	大蜜蜂 (Midway set 1)	大蜜蜂 (Midway set 1)	[Namco] (Midway license)
galagamk	大蜜蜂 (Midway set 2)	大蜜蜂 (Midway set 2)	[Namco] (Midway license)
gallag	大蜜蜂	大蜜蜂	bootleg
gatsbee	大蜜蜂 / Gatsbee	大蜜蜂 / Gatsbee	hack
digdug	挖金 (rev 2)	挖金 (rev 2)	Namco
digdugb	挖金 (rev 1)	挖金 (rev 1)	Namco
digdugat	挖金 (Atari, rev 2)	挖金 (Atari, rev 2)	[Namco] (Atari license)
digduga1	挖金 (Atari, rev 1)	挖金 (Atari, rev 1)	[Namco] (Atari license)
dzigzag	挖金 / Zig Zag (Dig Dug hardware)	挖金 / Zig Zag (Dig Dug hardware)	bootleg
xevious	鐵板陣 (Namco)	鐵板陣 (Namco)	Namco
xeviousa	鐵板陣 (Atari set 1)	鐵板陣 (Atari set 1)	Namco (Atari license)
xeviousb	鐵板陣 (Atari set 2)	鐵板陣 (Atari set 2)	Namco (Atari license)
xeviousc	鐵板陣 (Atari set 3)	鐵板陣 (Atari set 3)	Namco (Atari license)
xevios	鐵板陣	鐵板陣	bootleg
battles	鐵板陣 / Battles	鐵板陣 / Battles	bootleg
sxevious	超級鐵板陣	超級鐵板陣	Namco
superpac	超級小精靈	超級小精靈	Namco
superpcm	超級小精靈 (Midway)	超級小精靈 (Midway)	[Namco] (Bally Midway license)
pacnpal	小精靈 & 小精靈 / Pac & Pal	小精靈 & 小精靈 / Pac & Pal	Namco
pacnpal2	小精靈 & 小精靈 / Pac & Pal (older)	小精靈 & 小精靈 / Pac & Pal (older)	Namco
pacnchmp	小精靈 & 小精靈 / Pac-Man & Chomp Chomp	小精靈 & 小精靈 / Pac-Man & Chomp Chomp	Namco
mappy	貓捉老鼠 (美版)	貓捉老鼠 (美版)	Namco
mappyj	貓捉老鼠 (日版)	貓捉老鼠 (日版)	Namco
digdug2	挖金 II (New Ver.)	挖金 II (New Ver.)	Namco
digdug2o	挖金 II (Old Ver.)	挖金 II (Old Ver.)	Namco
grobda	坦克車 (New Ver.)	坦克車 (New Ver.)	Namco
grobda2	坦克車 (Old Ver. set 1)	坦克車 (Old Ver. set 1)	Namco
grobda3	坦克車 (Old Ver. set 2)	坦克車 (Old Ver. set 2)	Namco
gaplus	大蜜蜂 3 / Gaplus (rev. D)	大蜜蜂 3 / Gaplus (rev. D)	Namco
gaplusa	大蜜蜂 3 / Gaplus (alternate hardware)	大蜜蜂 3 / Gaplus (alternate hardware)	Namco
gapluso	大蜜蜂 3 / Gaplus (rev. B)	大蜜蜂 3 / Gaplus (rev. B)	Namco
galaga3	大蜜蜂 3 (rev. C)	大蜜蜂 3 (rev. C)	Namco
galaga3m	大蜜蜂 3 (set 3)	大蜜蜂 3 (set 3)	Namco
galaga3a	大蜜蜂 3 (set 2)	大蜜蜂 3 (set 2)	Namco
polepos	頂尖賽手 / Pole Position	頂尖賽手 / Pole Position	Namco
poleposa	頂尖賽手 / Pole Position (Atari version 2)	頂尖賽手 / Pole Position (Atari version 2)	Namco (Atari license)
polepos1	頂尖賽手 / Pole Position (Atari version 1)	頂尖賽手 / Pole Position (Atari version 1)	[Namco] (Atari license)
topracer	頂尖賽手 (set 1)	頂尖賽手 (set 1)	bootleg
topracra	頂尖賽手 (set 2)	頂尖賽手 (set 2)	bootleg
topracrb	頂尖賽手 (set 3)	頂尖賽手 (set 3)	bootleg
polepos2	頂尖賽手 II / Pole Position II	頂尖賽手 II / Pole Position II	Namco
poleps2a	頂尖賽手 II / Pole Position II (Atari)	頂尖賽手 II / Pole Position II (Atari)	Namco (Atari license)
poleps2b	頂尖賽手 II / Pole Position II (bootleg)	頂尖賽手 II / Pole Position II (bootleg)	bootleg
pacland	小精靈領域 (set 1)	小精靈領域 (set 1)	Namco
pacland2	小精靈領域 (set 2)	小精靈領域 (set 2)	Namco
pacland3	小精靈領域 (set 3)	小精靈領域 (set 3)	Namco
paclandm	小精靈領域 (Midway)	小精靈領域 (Midway)	[Namco] (Bally Midway license)
skykid	天空小子 (New Ver.)	天空小子 (New Ver.)	Namco
skykido	天空小子 (Old Ver.)	天空小子 (Old Ver.)	Namco
skykidd	天空小子 (60A1 Ver.)	天空小子 (60A1 Ver.)	Namco
metrocrs	障礙賽跑 (set 1)	障礙賽跑 (set 1)	Namco
metrocra	障礙賽跑 (set 2)	障礙賽跑 (set 2)	Namco
skykiddx	天空小子 Deluxe (set 1)	天空小子 Deluxe (set 1)	Namco
skykiddo	天空小子 Deluxe (set 2)	天空小子 Deluxe (set 2)	Namco
genpeitd	源平討魔傳	源平討魔傳	Namco
rthunder	滾雷 (new version)	滾雷 (new version)	Namco
rthundro	滾雷 (old version)	滾雷 (old version)	Namco
wndrmomo	神奇女孩	神奇女孩	Namco
shadowld	妖怪道中記	妖怪道中記	Namco
youkaidk	妖怪道中記 (日版 new version)	妖怪道中記 (日版 new version)	Namco
yokaidko	妖怪道中記 (日版 old version)	妖怪道中記 (日版 old version)	Namco
dspirit	龍魂 (new version)	龍魂 (new version)	Namco
dspirito	龍魂 (old version)	龍魂 (old version)	Namco
pacmania	瘋狂小精靈	瘋狂小精靈	Namco
pacmanij	瘋狂小精靈 (日版)	瘋狂小精靈 (日版)	Namco
galaga88	大蜜蜂 '88	大蜜蜂 '88	Namco
galag88j	大蜜蜂 '88 (日版)	大蜜蜂 '88 (日版)	Namco
ws	世界競技場 (日版)	世界競技場 (日版)	Namco
berabohm	超絕倫人 (日版 version C)	超絕倫人 (日版 version C)	Namco
beraboho	超絕倫人 (日版 version B)	超絕倫人 (日版 version B)	Namco
bakutotu	暴突 機銃艇	暴突 機銃艇	Namco
wldcourt	世界球場 (日版)	世界球場 (日版)	Namco
splatter	鬼屋 (日版)	鬼屋 (日版)	Namco
ws89	世界競技場 '89 (日版)	世界競技場 '89 (日版)	Namco
dangseed	危機四伏 (日版)	危機四伏 (日版)	Namco
ws90	世界競技場 '90 (日版)	世界競技場 '90 (日版)	Namco
pistoldm	手槍大名冒險 (日版)	手槍大名冒險 (日版)	Namco
boxyboy	倉庫番 (美版)	倉庫番 (美版)	Namco
soukobdx	倉庫番 / Souko Ban Deluxe (日版)	倉庫番 / Souko Ban Deluxe (日版)	Namco
puzlclub	Puzzle 俱樂部 (日版 prototype)	Puzzle 俱樂部 (日版 prototype)	Namco
tankfrce	坦克大戰 (美版)	坦克大戰 (美版)	Namco
tankfrcj	坦克大戰 (日版)	坦克大戰 (日版)	Namco
ordyne	歐坦救美 (日版, 英文版)	歐坦救美 (日版, 英文版)	Namco
ordynej	歐坦救美 (日版)	歐坦救美 (日版)	Namco
mirninja	未來忍者 (日版)	未來忍者 (日版)	Namco
kyukaidk	球界道中記 (日版 new version)	球界道中記 (日版 new version)	Namco
kyukaido	球界道中記 (日版 old version)	球界道中記 (日版 old version)	Namco
rthun2	滾雷 2	滾雷 2	Namco
rthun2j	滾雷 2 (日版)	滾雷 2 (日版)	Namco
sws	超級世界棒球 (日版)	超級世界棒球 (日版)	Namco
sws92	超級世界棒球 '92 (日版)	超級世界棒球 '92 (日版)	Namco
sws92g	超級世界棒球 '92 Gekitouban (日版)	超級世界棒球 '92 Gekitouban (日版)	Namco
sws93	超級世界棒球 '93 (日版)	超級世界棒球 '93 (日版)	Namco
bkrtmaq	爆裂問答 魔-Q 大冒險 (日版)	爆裂問答 魔-Q 大冒險 (日版)	Namco
quiztou	熱鬥! 激鬥! 問題島!! (日版)	熱鬥! 激鬥! 問題島!! (日版)	Namco
ptblank	槍林彈雨	槍林彈雨	Namco
gunbulet	槍林彈雨 (日版)	槍林彈雨 (日版)	Namco
gslgr94u	超級強打 '94	超級強打 '94	Namco
sws95	超級世界棒球 '95 (日版)	超級世界棒球 '95 (日版)	Namco
sws96	超級世界棒球 '96 (日版)	超級世界棒球 '96 (日版)	Namco
sws97	超級世界棒球 '97 (日版)	超級世界棒球 '97 (日版)	Namco
ncv1	Namco 名作劇場 Vol.1	Namco 名作劇場 Vol.1	Namco
ncv1j	Namco 名作劇場 Vol.1 (日版, v1.00)	Namco 名作劇場 Vol.1 (日版, v1.00)	Namco
ncv1j2	Namco 名作劇場 Vol.1 (日版, v1.03)	Namco 名作劇場 Vol.1 (日版, v1.03)	Namco
ncv2	Namco 名作劇場 Vol.2	Namco 名作劇場 Vol.2	Namco
ncv2j	Namco 名作劇場 Vol.2 (日版)	Namco 名作劇場 Vol.2 (日版)	Namco
redclash	赤色衝擊	赤色衝擊	Tehkan
redclask	赤色衝擊 (Kaneko)	赤色衝擊 (Kaneko)	Kaneko
devzone	魔鬼地帶	魔鬼地帶	Universal
devzone2	魔鬼地帶 (easier)	魔鬼地帶 (easier)	Universal
nomnlnd	戰國自衛隊	戰國自衛隊	Universal
nomnlndg	戰國自衛隊 (Gottlieb)	戰國自衛隊 (Gottlieb)	Universal (Gottlieb license)
docastle	Mr. Do vs. 獨角獸 / Mr. Do 的城堡 (set 1)	Mr. Do vs. 獨角獸 / Mr. Do 的城堡 (set 1)	Universal
docastl2	Mr. Do vs. 獨角獸 / Mr. Do 的城堡 (set 2)	Mr. Do vs. 獨角獸 / Mr. Do 的城堡 (set 2)	Universal
docastlo	Mr. Do vs. 獨角獸 / Mr. Do 的城堡 (older)	Mr. Do vs. 獨角獸 / Mr. Do 的城堡 (older)	Universal
douni	Mr. Do vs. 獨角獸	Mr. Do vs. 獨角獸	Universal
dowild	Mr. Do 的暴走	Mr. Do 的暴走	Universal
helifire	太陽火 (set 1)	太陽火 (set 1)	Nintendo
helifira	太陽火 (set 2)	太陽火 (set 2)	Nintendo
dkong	大金剛 (美版 set 1)	大金剛 (美版 set 1)	Nintendo of America
dkongo	大金剛 (美版 set 2)	大金剛 (美版 set 2)	Nintendo
dkongjp	大金剛 (日版 set 1)	大金剛 (日版 set 1)	Nintendo
dkongjo	大金剛 (日版 set 2)	大金剛 (日版 set 2)	Nintendo
dkongjo1	大金剛 (日版 set 3) (bad dump?)	大金剛 (日版 set 3) (bad dump?)	Nintendo
dkongjr	大金剛 Junior (美版)	大金剛 Junior (美版)	Nintendo of America
dkongjrj	大金剛 Jr. (日版)	大金剛 Jr. (日版)	Nintendo
dkngjnrj	大金剛 Junior (日版?)	大金剛 Junior (日版?)	Nintendo
dkongjrb	大金剛 Jr. (bootleg)	大金剛 Jr. (bootleg)	bootleg
dkngjnrb	大金剛 Junior (bootleg?)	大金剛 Junior (bootleg?)	Nintendo of America
dkong3	大金剛 3 (美版)	大金剛 3 (美版)	Nintendo of America
dkong3j	大金剛 3 (日版)	大金剛 3 (日版)	Nintendo
dkong3b	大金剛 3 (bootleg on Donkey Kong Jr. hardware)	大金剛 3 (bootleg on Donkey Kong Jr. hardware)	bootleg
mario	馬利歐兄弟 (美版)	馬利歐兄弟 (美版)	Nintendo of America
mariojp	馬利歐兄弟 (日版)	馬利歐兄弟 (日版)	Nintendo
masao	馬利歐兄弟 / Masao	馬利歐兄弟 / Masao	bootleg
pestplce	馬利歐兄弟 / Pest Place	馬利歐兄弟 / Pest Place	bootleg
popeye	大力水手 (revision D)	大力水手 (revision D)	Nintendo
popeyeu	大力水手 (revision D not protected)	大力水手 (revision D not protected)	Nintendo
popeyef	大力水手 (revision F)	大力水手 (revision F)	Nintendo
popeyebl	大力水手 (bootleg)	大力水手 (bootleg)	bootleg
pc_tenis	網球 (PlayChoice-10)	網球 (PlayChoice-10)	Nintendo
pc_mario	馬利歐兄弟 (PlayChoice-10)	馬利歐兄弟 (PlayChoice-10)	Nintendo
pc_bball	棒球 (PlayChoice-10)	棒球 (PlayChoice-10)	Nintendo of America
pc_golf	高爾夫 (PlayChoice-10)	高爾夫 (PlayChoice-10)	Nintendo
pc_kngfu	功夫 (PlayChoice-10)	功夫 (PlayChoice-10)	Irem (Nintendo license)
pc_smb	超級馬利歐兄弟 (PlayChoice-10)	超級馬利歐兄弟 (PlayChoice-10)	Nintendo
pc_vball	排球 (PlayChoice-10)	排球 (PlayChoice-10)	Nintendo
pc_trjan	鬥者輓歌 (PlayChoice-10)	鬥者輓歌 (PlayChoice-10)	Capcom USA (Nintendo of America license)
pc_cntra	魂斗羅 (PlayChoice-10)	魂斗羅 (PlayChoice-10)	Konami (Nintendo of America license)
pc_ngaid	忍者外傳 (PlayChoice-10)	忍者外傳 (PlayChoice-10)	Tecmo (Nintendo of America license)
pc_tmnt	忍者龜 (PlayChoice-10)	忍者龜 (PlayChoice-10)	Konami (Nintendo of America license)
pc_bstar	棒球之星 (PlayChoice-10)	棒球之星 (PlayChoice-10)	SNK (Nintendo of America license)
pc_drmro	馬利歐醫生 (PlayChoice-10)	馬利歐醫生 (PlayChoice-10)	Nintendo
pc_ddrgn	雙截龍 (PlayChoice-10)	雙截龍 (PlayChoice-10)	Technos
pc_smb2	超級馬利歐兄弟 2 (PlayChoice-10)	超級馬利歐兄弟 2 (PlayChoice-10)	Nintendo
pc_smb3	超級馬利歐兄弟 3 (PlayChoice-10)	超級馬利歐兄弟 3 (PlayChoice-10)	Nintendo
pc_mman3	洛克人 III (PlayChoice-10)	洛克人 III (PlayChoice-10)	Capcom USA (Nintendo of America license)
pc_suprc	超級魂斗羅 (PlayChoice-10)	超級魂斗羅 (PlayChoice-10)	Konami (Nintendo of America license)
pc_tmnt2	忍者龜 II (PlayChoice-10)	忍者龜 II (PlayChoice-10)	Konami (Nintendo of America license)
pc_wcup	熱血高校躲避球 (PlayChoice-10)	熱血高校躲避球 (PlayChoice-10)	Technos (Nintendo license)
pc_ngai2	忍者外傳 II (PlayChoice-10)	忍者外傳 II (PlayChoice-10)	Tecmo (Nintendo of America license)
pc_ngai3	忍者外傳 III (PlayChoice-10)	忍者外傳 III (PlayChoice-10)	Tecmo (Nintendo of America license)
pc_moglf	馬利歐的戶外高爾夫 (PlayChoice-10)	馬利歐的戶外高爾夫 (PlayChoice-10)	Nintendo
cstlevna	Vs. 惡魔城	Vs. 惡魔城	Konami
drmario	Vs. 馬利歐醫生	Vs. 馬利歐醫生	Nintendo
rbibb	Vs. Atari R.B.I. 棒球 (set 1)	Vs. Atari R.B.I. 棒球 (set 1)	Namco
rbibba	Vs. Atari R.B.I. 棒球 (set 2)	Vs. Atari R.B.I. 棒球 (set 2)	Namco
suprmrio	Vs. 超級馬利歐兄弟	Vs. 超級馬利歐兄弟	Nintendo
vsskykid	Vs. 天空小子	Vs. 天空小子	Namco
vspinbal	Vs. 彈珠台	Vs. 彈珠台	Nintendo
vspinblj	Vs. 彈珠台 (日版)	Vs. 彈珠台 (日版)	Nintendo
vsslalom	Vs. 障礙滑雪賽	Vs. 障礙滑雪賽	Rare LTD.
vssoccer	Vs. 足球	Vs. 足球	Nintendo
vstetris	Vs. 俄羅斯方塊	Vs. 俄羅斯方塊	Academysoft-Elory
topgun	Vs. 捍衛戰士	Vs. 捍衛戰士	Konami
vstennis	Vs. 網球	Vs. 網球	Nintendo
vstennij	Vs. 網球 (日版)	Vs. 網球 (日版)	Nintendo
vsmahjng	Vs. 麻雀 (日版)	Vs. 麻雀 (日版)	Nintendo
vsbball	Vs. 棒球	Vs. 棒球	Nintendo of America
vsbballj	Vs. 棒球 (日版 set 1)	Vs. 棒球 (日版 set 1)	Nintendo of America
vsbbalja	Vs. 棒球 (日版 set 2)	Vs. 棒球 (日版 set 2)	Nintendo of America
vsbbaljb	Vs. 棒球 (日版 set 3)	Vs. 棒球 (日版 set 3)	Nintendo of America
seawolf	海狼	海狼	Midway
maze	奇異迷宮	奇異迷宮	Midway
desertgu	沙漠槍手	沙漠槍手	Midway
phantom2	幻影 II	幻影 II	Midway
bowler	4 人保齡球	4 人保齡球	Midway
invaders	太空入侵者	太空入侵者	Midway
invad2ct	太空入侵者 II (Midway, 檯面型)	太空入侵者 II (Midway, 檯面型)	Midway
invadpt2	太空入侵者 Part II (Taito)	太空入侵者 Part II (Taito)	Taito
invaddlx	太空入侵者 Part II / 太空入侵者 太空入侵者 Part II / Deluxe	太空入侵者 Part II / 太空入侵者 太空入侵者 Part II / Deluxe	Midway
moonbase	太空入侵者 Part II / Moon Base	太空入侵者 Part II / Moon Base	Nichibutsu
searthin	太空入侵者 / Super Earth Invasion (set 1)	太空入侵者 / Super Earth Invasion (set 1)	bootleg
searthia	太空入侵者 / Super Earth Invasion (set 2)	太空入侵者 / Super Earth Invasion (set 2)	bootleg
invadrmr	太空入侵者 (Model Racing)	太空入侵者 (Model Racing)	Model Racing
spaceatt	太空入侵者 / 太空攻擊	太空入侵者 / 太空攻擊	Video Games GMBH
spaceat2	太空入侵者 / 太空攻擊 II	太空入侵者 / 太空攻擊 II	Zenitone-Microsec Ltd
sinvzen	太空入侵者 (Zenitone-Microsec)	太空入侵者 (Zenitone-Microsec)	Zenitone-Microsec Ltd
superinv	太空入侵者 / Super Invaders	太空入侵者 / Super Invaders	bootleg
invasion	太空入侵者 / Invasion	太空入侵者 / Invasion	Sidam
sstrangr	太空陌生人	太空陌生人	Yachiyo Electronics, Ltd.
sstrngr2	太空陌生人 2	太空陌生人 2	Yachiyo Electronics, Ltd.
sinvemag	太空入侵者 / Super Invaders (EMAG)	太空入侵者 / Super Invaders (EMAG)	bootleg
jspecter	太空入侵者 / Jatre Specter (set 1)	太空入侵者 / Jatre Specter (set 1)	Jatre
jspectr2	太空入侵者 / Jatre Specter (set 2)	太空入侵者 / Jatre Specter (set 2)	Jatre
galxwars	銀河戰爭 (Universal set 1)	銀河戰爭 (Universal set 1)	Universal
galxwar2	銀河戰爭 (Universal set 2)	銀河戰爭 (Universal set 2)	Universal
galxwart	銀河戰爭 (Taito?)	銀河戰爭 (Taito?)	Taito?
starw	銀河戰爭 / Star Wars	銀河戰爭 / Star Wars	bootleg
lrescue	月球營救	月球營救	Taito
grescue	月球營救 / Galaxy Rescue	月球營救 / Galaxy Rescue	Taito (Universal license?)
desterth	月球營救 / Destination Earth	月球營救 / Destination Earth	bootleg
cosmicmo	太空入侵者 / 宇宙怪物	太空入侵者 / 宇宙怪物	Universal
cosmicm2	太空入侵者 2 / 宇宙怪物 2	太空入侵者 2 / 宇宙怪物 2	Universal
ozmawars	Ozma 戰爭 (set 1)	Ozma 戰爭 (set 1)	SNK
ozmawar2	Ozma 戰爭 (set 2)	Ozma 戰爭 (set 2)	SNK
solfight	Ozma 戰爭 / 太陽格鬥	Ozma 戰爭 / 太陽格鬥	bootleg
spaceph	Ozma 戰爭 / 宇宙幻影	Ozma 戰爭 / 宇宙幻影	Zilec Games
lupin3	魯邦三世	魯邦三世	Taito
spclaser	宇宙鐳射	宇宙鐳射	GamePlan (Taito)
laser	宇宙鐳射 / Laser	宇宙鐳射 / Laser	<unknown>
spcewarl	宇宙鐳射 / Space War (Leijac)	宇宙鐳射 / Space War (Leijac)	Leijac (Konami)
m79amb	M79 伏擊	M79 伏擊	RamTek
alieninv	太空入侵者 / 外星人入侵 Part II	太空入侵者 / 外星人入侵 Part II	bootleg
tst_invd	太空入侵者 Test ROM	太空入侵者 Test ROM	Test ROM
sitv	太空入侵者 (TV Version)	太空入侵者 (TV Version)	Taito
sicv	太空入侵者 (CV Version)	太空入侵者 (CV Version)	Taito
sisv	太空入侵者 (SV Version)	太空入侵者 (SV Version)	Taito
sisv2	太空入侵者 (SV Version 2)	太空入侵者 (SV Version 2)	Taito
spacewr3	太空入侵者 / 太空戰爭 Part 3	太空入侵者 / 太空戰爭 Part 3	bootleg
invaderl	太空入侵者 (Logitec)	太空入侵者 (Logitec)	bootleg
invader4	太空入侵者 Part 4	太空入侵者 Part 4	bootleg
yosakdon	與作和東平 (set 1)	與作和東平 (set 1)	Wing
yosakdoa	與作和東平 (set 2)	與作和東平 (set 2)	Wing
spceking	太空入侵者 / 宇宙之王	太空入侵者 / 宇宙之王	Leijac (Konami)
spcewars	太空入侵者 / 太空戰爭 (Sanritsu)	太空入侵者 / 太空戰爭 (Sanritsu)	Sanritsu
seawolf2	海狼 II	海狼 II	Midway
twotiger	雙虎 (dedicated)	雙虎 (dedicated)	Bally Midway
twotigrc	雙虎 (Tron conversion)	雙虎 (Tron conversion)	Bally Midway
spyhunt	間諜獵人	間諜獵人	Bally Midway
spyhunt2	間諜獵人 2 (rev 2)	間諜獵人 2 (rev 2)	Bally Midway
spyhnt2a	間諜獵人 2 (rev 1)	間諜獵人 2 (rev 1)	Bally Midway
sentetst	Sente 社診斷錄音盒	Sente 社診斷錄音盒	Bally/Sente
snakjack	頑皮傑克	頑皮傑克	Bally/Sente
minigolf	迷你高爾夫 (set 1)	迷你高爾夫 (set 1)	Bally/Sente
minigol2	迷你高爾夫 (set 2)	迷你高爾夫 (set 2)	Bally/Sente
redalert	紅色警戒	紅色警戒	Irem + GDI
mpatrol	月球巡警	月球巡警	Irem
mpatrolw	月球巡警 (Williams)	月球巡警 (Williams)	Irem (Williams license)
troangel	夏日天使	夏日天使	Irem
kungfum	成龍踢館	成龍踢館	Irem
kungfud	成龍踢館 (Data East)	成龍踢館 (Data East)	Irem (Data East license)
spartanx	成龍踢館 / Spartan X (日版)	成龍踢館 / Spartan X (日版)	Irem
kungfub	成龍踢館 (bootleg set 1)	成龍踢館 (bootleg set 1)	bootleg
kungfub2	成龍踢館 (bootleg set 2)	成龍踢館 (bootleg set 2)	bootleg
kidniki	快傑 Yancha 丸 (美版)	快傑 Yancha 丸 (美版)	Irem (Data East USA license)
yanchamr	快傑 Yancha 丸 (日版)	快傑 Yancha 丸 (日版)	Irem
spelunkr	洞穴探險	洞穴探險	Irem (licensed from Broderbund)
spelnkrj	洞穴探險 (日版)	洞穴探險 (日版)	Irem (licensed from Broderbund)
spelunk2	洞穴探險 II	洞穴探險 II	Irem (licensed from Broderbund)
youjyudn	妖獸傳 (日版)	妖獸傳 (日版)	Irem
vigilant	成龍踢館 II (世界版)	成龍踢館 II (世界版)	Irem
vigilntu	成龍踢館 II (美版)	成龍踢館 II (美版)	Irem (Data East USA license)
vigilntj	成龍踢館 II (日版)	成龍踢館 II (日版)	Irem
kikcubic	迷宮島 (日版)	迷宮島 (日版)	Irem
rtype	異形戰機 (日版)	異形戰機 (日版)	Irem
rtypepj	異形戰機 (日版 prototype)	異形戰機 (日版 prototype)	Irem
rtypeu	異形戰機 (美版)	異形戰機 (美版)	Irem (Nintendo of America license)
bchopper	Mr. HELI 大冒險 / Battle Chopper	Mr. HELI 大冒險 / Battle Chopper	Irem
mrheli	Mr. HELI 大冒險	Mr. HELI 大冒險	Irem
nspirit	最後忍道 / Ninja Spirit	最後忍道 / Ninja Spirit	Irem
nspiritj	最後忍道 (日版)	最後忍道 (日版)	Irem
xmultipl	X 戰機 (日版)	X 戰機 (日版)	Irem
rtype2	異形戰機 II	異形戰機 II	Irem
rtype2j	異形戰機 II (日版)	異形戰機 II (日版)	Irem
hharry	大工之源 (世界版)	大工之源 (世界版)	Irem
hharryu	大工之源 (美版)	大工之源 (美版)	Irem America
dkgensan	大工之源 (日版)	大工之源 (日版)	Irem
dkgenm72	大工之源 (日版, M72)	大工之源 (日版, M72)	Irem
airduel	空中決戰 (日版)	空中決戰 (日版)	Irem
cosmccop	雷馳 - 武裝警察 / Cosmic Cop (世界版)	雷馳 - 武裝警察 / Cosmic Cop (世界版)	Irem
gallop	雷馳 - 武裝警察 (日版)	雷馳 - 武裝警察 (日版)	Irem
kengo	劍豪	劍豪	Irem
sichuan2	四川省 女子寮編 II (hack?) (set 1)	四川省 女子寮編 II (hack?) (set 1)	Tamtex
sichuana	四川省 女子寮編 II (hack?) (set 2)	四川省 女子寮編 II (hack?) (set 2)	Tamtex
shisen	四川省 女子寮編 (日版)	四川省 女子寮編 (日版)	Tamtex
matchit	四川省 女子寮編 / Match It	四川省 女子寮編 / Match It	Tamtex
hasamu	霸沙夢 (日版)	霸沙夢 (日版)	Irem
gunforce	戰火驚魂 (世界版)	戰火驚魂 (世界版)	Irem
gunforcu	戰火驚魂 (美版)	戰火驚魂 (美版)	Irem America
gunforcj	戰火驚魂 (日版)	戰火驚魂 (日版)	Irem
bmaster	刀鋒領主 (世界版)	刀鋒領主 (世界版)	Irem
lethalth	致命因子 (世界版)	致命因子 (世界版)	Irem
thndblst	致命因子 (日版)	致命因子 (日版)	Irem
uccops	玉面威龍 / 暴力刑警 (世界版)	玉面威龍 / 暴力刑警 (世界版)	Irem
uccopsj	玉面威龍 / 暴力刑警 (日版)	玉面威龍 / 暴力刑警 (日版)	Irem
mysticri	魔法警備隊 (世界版)	魔法警備隊 (世界版)	Irem
gunhohki	魔法警備隊 (日版)	魔法警備隊 (日版)	Irem
hook	虎克船長 (世界版)	虎克船長 (世界版)	Irem
hooku	虎克船長 (美版)	虎克船長 (美版)	Irem America
hookj	虎克船長 (日版)	虎克船長 (日版)	Irem
rtypeleo	異形戰機 Leo (世界版 rev. C)	異形戰機 Leo (世界版 rev. C)	Irem
rtypelej	異形戰機 Leo (日版 rev. D)	異形戰機 Leo (日版 rev. D)	Irem
inthunt	海底大戰爭 (世界版) 	海底大戰爭 (世界版) 	Irem
inthuntu	海底大戰爭 (美版)	海底大戰爭 (美版)	Irem America
kaiteids	海底大戰爭 (日版)	海底大戰爭 (日版)	Irem
nbbatman	棒球殺手 (美版)	棒球殺手 (美版)	Irem America
leaguemn	棒球殺手 (日版)	棒球殺手 (日版)	Irem
ssoldier	完美戰士 (美版)	完美戰士 (美版)	Irem America
psoldier	完美戰士 (日版)	完美戰士 (日版)	Irem
dsccr94j	夢幻足球 '94 (日版)	夢幻足球 '94 (日版)	Irem
gunforc2	戰火驚魂 2 (美版)	戰火驚魂 2 (美版)	Irem
geostorm	戰火驚魂 2 (日版)	戰火驚魂 2 (日版)	Irem
firebarr	火爆戰機 (日版)	火爆戰機 (日版)	Irem
dsoccr94	夢幻足球 '94	夢幻足球 '94	Irem (Data East Corporation license)
mplanets	瘋狂星球	瘋狂星球	Gottlieb
mplanuk	瘋狂星球 (英國版)	瘋狂星球 (英國版)	Gottlieb (Taitel license)
qbertqub	Q*bert 的方塊	Q*bert 的方塊	Mylstar
junglek	叢林之王 (日版)	叢林之王 (日版)	Taito Corporation
junglkj2	叢林之王 (日版, earlier)	叢林之王 (日版, earlier)	Taito Corporation
jungleh	叢林之王 / 叢林狩獵 (美版)	叢林之王 / 叢林狩獵 (美版)	Taito America Corporation
junglhbr	叢林之王 / 叢林狩獵 (巴西版)	叢林之王 / 叢林狩獵 (巴西版)	Taito do Brasil
piratpet	叢林之王 / 海盜彼得	叢林之王 / 海盜彼得	Taito America Corporation
alpine	高山滑雪 (set 1)	高山滑雪 (set 1)	Taito Corporation
alpinea	高山滑雪 (set 2)	高山滑雪 (set 2)	Taito Corporation
timetunl	時光隧道	時光隧道	Taito Corporation
wwestern	狂野西部 (set 1)	狂野西部 (set 1)	Taito Corporation
wwester1	狂野西部 (set 2)	狂野西部 (set 2)	Taito Corporation
frontlin	前線	前線	Taito Corporation
elevator	電梯大戰	電梯大戰	Taito Corporation
elevatob	電梯大戰 (bootleg)	電梯大戰 (bootleg)	bootleg
bioatack	生化攻擊	生化攻擊	Taito Corporation (Fox Video Games license)
sfposeid	海神戰士	海神戰士	Taito Corporation
crbaloon	瘋狂氣球 (set 1)	瘋狂氣球 (set 1)	Taito Corporation
crbalon2	瘋狂氣球 (set 2)	瘋狂氣球 (set 2)	Taito Corporation
gsword	擊劍士 (世界版?)	擊劍士 (世界版?)	Taito Corporation
gsword2	擊劍士 (日版?)	擊劍士 (日版?)	Taito Corporation
lkage	影子傳說	影子傳說	Taito Corporation
lkageb	影子傳說 (bootleg set 1)	影子傳說 (bootleg set 1)	bootleg
lkageb2	影子傳說 (bootleg set 2)	影子傳說 (bootleg set 2)	bootleg
lkageb3	影子傳說 (bootleg set 3)	影子傳說 (bootleg set 3)	bootleg
retofinv	侵略者回歸	侵略者回歸	Taito Corporation
retofin1	侵略者回歸 (bootleg set 1)	侵略者回歸 (bootleg set 1)	bootleg
retofin2	侵略者回歸 (bootleg set 2)	侵略者回歸 (bootleg set 2)	bootleg
fightrol	滾軸王牌 / Fighting Roller	滾軸王牌 / Fighting Roller	[Kaneko] (Taito license)
rollace	滾軸王牌 / Roller Aces (set 1)	滾軸王牌 / Roller Aces (set 1)	[Kaneko] (Williams license)
rollace2	滾軸王牌 / Roller Aces (set 2)	滾軸王牌 / Roller Aces (set 2)	[Kaneko] (Williams license)
tsamurai	侍 日本一 (set 1)	侍 日本一 (set 1)	Taito
tsamura2	侍 日本一 (set 2)	侍 日本一 (set 2)	Taito
nunchaku	功夫少女	功夫少女	Taito
yamagchi	Go Go 山口君 / Yuke Yuke Yamaguchi-kun	Go Go 山口君 / Yuke Yuke Yamaguchi-kun	Taito
m660	660 任務 (美版)	660 任務 (美版)	[Woodplace Inc.] Taito America Corporation
m660j	660 任務 (日版)	660 任務 (日版)	[Woodplace Inc.] Taito Corporation
m660b	660 任務 (bootleg)	660 任務 (bootleg)	bootleg
alphaxz	660 任務 / The Alphax Z (日版)	660 任務 / The Alphax Z (日版)	Ed / Woodplace Inc.
flstory	仙境物語	仙境物語	Taito
flstoryj	仙境物語 (日版)	仙境物語 (日版)	Taito
onna34ro	女三四郎 / 颶風女孩 (set 1)	女三四郎 / 颶風女孩 (set 1)	Taito
onna34ra	女三四郎 / 颶風女孩 (set 2)	女三四郎 / 颶風女孩 (set 2)	Taito
gladiatr	黃金城 (美版)	黃金城 (美版)	Taito America Corporation
ogonsiro	黃金城 (日版)	黃金城 (日版)	Taito Corporation
ksayakyu	草野球	草野球	Taito Corporation
lsasquad	陸海空最前線 / Land Sea Air Squad	陸海空最前線 / Land Sea Air Squad	Taito
storming	陸海空最前線 / Storming Party	陸海空最前線 / Storming Party	Taito
tokio	轟炸東京 (美版)	轟炸東京 (美版)	Taito America Corporation (Romstar license)
tokiob	轟炸東京 (bootleg)	轟炸東京 (bootleg)	bootleg
bublbobl	泡泡龍	泡泡龍	Taito Corporation
bublbobr	泡泡龍 (美版 with mode select)	泡泡龍 (美版 with mode select)	Taito America Corporation (Romstar license)
bubbobr1	泡泡龍 (美版)	泡泡龍 (美版)	Taito America Corporation (Romstar license)
boblbobl	泡泡龍 / Bobble Bobble	泡泡龍 / Bobble Bobble	bootleg
sboblbob	泡泡龍 / Super Bobble Bobble	泡泡龍 / Super Bobble Bobble	bootleg
missb2	泡泡龍 / Miss Bubble 2	泡泡龍 / Miss Bubble 2	Alpha Co
kikikai	奇奇怪界	奇奇怪界	Taito Corporation
darius	太空戰機 (世界版)	太空戰機 (世界版)	Taito Corporation Japan
dariusj	太空戰機 (日版)	太空戰機 (日版)	Taito Corporation
dariuso	太空戰機 (日版 old version)	太空戰機 (日版 old version)	Taito Corporation
dariuse	太空戰機 (Extra) (日版)	太空戰機 (Extra) (日版)	Taito Corporation
topspeed	最高時速 (世界版)	最高時速 (世界版)	Taito Corporation Japan
topspedu	最高時速 (美版)	最高時速 (美版)	Taito America Corporation (Romstar license)
fullthrl	最高時速 (日版)	最高時速 (日版)	Taito Corporation
opwolf	烏茲衝鋒槍 (世界版)	烏茲衝鋒槍 (世界版)	Taito Corporation Japan
opwolfu	烏茲衝鋒槍 (美版)	烏茲衝鋒槍 (美版)	Taito America Corporation
opwolfb	烏茲衝鋒槍	烏茲衝鋒槍	bootleg
othunder	霹靂行動 (世界版)	霹靂行動 (世界版)	Taito Corporation Japan
othundu	霹靂行動 (美版)	霹靂行動 (美版)	Taito America Corporation
othunduo	霹靂行動 (美版, 舊版)	霹靂行動 (美版, 舊版)	Taito America Corporation
othundrj	霹靂行動 (日版)	霹靂行動 (日版)	Taito Corporation
rainbow	彩虹島 (新版)	彩虹島 (新版)	Taito Corporation
rainbowo	彩虹島 (舊版)	彩虹島 (舊版)	Taito Corporation
rainbowe	彩虹島 (Extra)	彩虹島 (Extra)	Taito Corporation
jumping	彩虹島 / Jumping	彩虹島 / Jumping	bootleg
minivadr	迷你小蜜蜂	迷你小蜜蜂	Taito Corporation
bonzeadv	地獄小和尚 (世界版)	地獄小和尚 (世界版)	Taito Corporation Japan
bonzeadu	地獄小和尚 (美版)	地獄小和尚 (美版)	Taito America Corporation
jigkmgri	地獄小和尚 (日版)	地獄小和尚 (日版)	Taito Corporation
asuka	飛鳥 & 飛鳥 (日版)	飛鳥 & 飛鳥 (日版)	Taito Corporation
earthjkr	國聯防衛軍: 地球王牌 (日版)	國聯防衛軍: 地球王牌 (日版)	Visco
eto	古今東西干支物語 (日版)	古今東西干支物語 (日版)	Visco
wgp	國際機車大獎賽 (美版)	國際機車大獎賽 (美版)	Taito America Corporation
wgpj	國際機車大獎賽 (日版)	國際機車大獎賽 (日版)	Taito Corporation
wgpjoy	國際機車大獎賽 (搖桿版 set 1) (日版)	國際機車大獎賽 (搖桿版 set 1) (日版)	Taito Corporation
wgpjoya	國際機車大獎賽 (搖桿版 set 2) (日版)	國際機車大獎賽 (搖桿版 set 2) (日版)	Taito Corporation
wgp2	國際機車大獎賽 2 (日版)	國際機車大獎賽 2 (日版)	Taito Corporation
ninjaw	忍者武士 (世界版)	忍者武士 (世界版)	Taito Corporation Japan
ninjawj	忍者武士 (日版)	忍者武士 (日版)	Taito Corporation
darius2	太空戰機 II (日版)	太空戰機 II (日版)	Taito Corporation
darius2d	太空戰機 II (雙螢幕) (日版)	太空戰機 II (雙螢幕) (日版)	Taito Corporation
drius2do	太空戰機 II (雙螢幕) (日版 舊版)	太空戰機 II (雙螢幕) (日版 舊版)	Taito Corporation
warriorb	武士之刃 (日版)	武士之刃 (日版)	Taito Corporation
superman	超人	超人	Taito Corporation
suprmanj	超人 (日版)	超人 (日版)	Taito Corporation
twinhawk	大旋風 (世界版)	大旋風 (世界版)	Taito Corporation Japan
twinhwku	大旋風 (美版)	大旋風 (美版)	Taito America Corporation
daisenpu	大旋風 (日版)	大旋風 (日版)	Taito Corporation
drtoppel	Toppel 博士探險隊 (世界版)	Toppel 博士探險隊 (世界版)	Taito Corporation Japan
drtopplu	Toppel 博士探險隊 (美版)	Toppel 博士探險隊 (美版)	Taito America Corporation
drtopplj	Toppel 博士探險隊 (日版)	Toppel 博士探險隊 (日版)	Taito Corporation
kageki	火激 (美版)	火激 (美版)	Taito America Corporation (Romstar license)
kagekij	火激 (日版)	火激 (日版)	Taito Corporation
chukatai	中華大仙 (世界版)	中華大仙 (世界版)	Taito Corporation Japan
chukatau	中華大仙 (美版)	中華大仙 (美版)	Taito America Corporation
chukataj	中華大仙 (日版)	中華大仙 (日版)	Taito Corporation
kurikint	功里金團 (世界版)	功里金團 (世界版)	Taito Corporation Japan
kurikinu	功里金團 (美版)	功里金團 (美版)	Taito America Corporation
kurikinj	功里金團 (日版)	功里金團 (日版)	Taito Corporation
kurikina	功里金團 (世界版, prototype?)	功里金團 (世界版, prototype?)	Taito Corporation Japan
fhawk	戰鬥獵鷹 (世界版)	戰鬥獵鷹 (世界版)	Taito Corporation Japan
fhawkj	戰鬥獵鷹 (日版)	戰鬥獵鷹 (日版)	Taito Corporation
champwr	冠軍摔跤 (世界版)	冠軍摔跤 (世界版)	Taito Corporation Japan
champwru	冠軍摔跤 (美版)	冠軍摔跤 (美版)	Taito America Corporation
champwrj	冠軍摔跤 (日版)	冠軍摔跤 (日版)	Taito Corporation
dleague	震撼聯盟 (日版)	震撼聯盟 (日版)	Taito Corporation
rambo3	藍波 III (歐洲版 set 1)	藍波 III (歐洲版 set 1)	Taito Europe Corporation
rambo3ae	藍波 III (歐洲版 set 2)	藍波 III (歐洲版 set 2)	Taito Europe Corporation
rambo3a	藍波 III (美版)	藍波 III (美版)	Taito America Corporation
crimec	罪惡都市 (世界版)	罪惡都市 (世界版)	Taito Corporation Japan
crimecu	罪惡都市 (美版)	罪惡都市 (美版)	Taito America Corporation
crimecj	罪惡都市 (日版)	罪惡都市 (日版)	Taito Corporation
tetrist	俄羅斯方塊 (日版, B-System, YM2610)	俄羅斯方塊 (日版, B-System, YM2610)	Sega
tetrista	俄羅斯方塊 (日版, B-System, YM2203)	俄羅斯方塊 (日版, B-System, YM2203)	Sega
viofight	暴力格鬥 (世界版)	暴力格鬥 (世界版)	Taito Corporation Japan
viofighu	暴力格鬥 (美版)	暴力格鬥 (美版)	Taito America Corporation
ashura	阿修羅風暴 (日版)	阿修羅風暴 (日版)	Taito Corporation
ashurau	阿修羅風暴 (美版)	阿修羅風暴 (美版)	Taito America Corporation
silentd	沉默之龍 (世界版)	沉默之龍 (世界版)	Taito Corporation Japan
silentdj	沉默之龍 (日版)	沉默之龍 (日版)	Taito Corporation
ryujin	龍神 (日版)	龍神 (日版)	Taito Corporation
qzshowby	問答世界 (日版)	問答世界 (日版)	Taito Corporation
pbobble	泡泡龍解謎 (日版, B-System)	泡泡龍解謎 (日版, B-System)	Taito Corporation
spacedx	太空入侵者 DX (美版) v2.1	太空入侵者 DX (美版) v2.1	Taito Corporation
spacedxj	太空入侵者 DX (日版) v2.1	太空入侵者 DX (日版) v2.1	Taito Corporation
spacedxo	太空入侵者 DX (日版) v2.0	太空入侵者 DX (日版) v2.0	Taito Corporation
nightstr	午夜出擊 (美版)	午夜出擊 (美版)	Taito America Corporation
sci	S.C.I. 特別刑事調查組 (世界版 set 1)	S.C.I. 特別刑事調查組 (世界版 set 1)	Taito Corporation Japan
scia	S.C.I. 特別刑事調查組 (世界版 set 2)	S.C.I. 特別刑事調查組 (世界版 set 2)	Taito Corporation Japan
sciu	S.C.I. 特別刑事調查組 (美版)	S.C.I. 特別刑事調查組 (美版)	Taito America Corporation
bshark	獵鯊行動 (美版)	獵鯊行動 (美版)	Taito America Corporation
bsharkj	獵鯊行動 (日版)	獵鯊行動 (日版)	Taito Corporation
dblaxle	四驅賽車 (美版)	四驅賽車 (美版)	Taito America Corporation
pwheelsj	四驅賽車 (日版)	四驅賽車 (日版)	Taito Corporation
superchs	大追捕 - 罪惡終結者 (美版)	大追捕 - 罪惡終結者 (美版)	Taito America Corporation
finalb	最終打擊 (世界版)	最終打擊 (世界版)	Taito Corporation Japan
finalbj	最終打擊 (日版)	最終打擊 (日版)	Taito Corporation
finalbu	最終打擊 (美版)	最終打擊 (美版)	Taito America Corporation
thundfox	雷狐戰士 (世界版)	雷狐戰士 (世界版)	Taito Corporation Japan
thndfoxu	雷狐戰士 (美版)	雷狐戰士 (美版)	Taito America Corporation
thndfoxj	雷狐戰士 (日版)	雷狐戰士 (日版)	Taito Corporation
qtorimon	苦胃頭捕物帳 (日版)	苦胃頭捕物帳 (日版)	Taito Corporation
liquidk	Baku 女士大冒險 / 水之精靈 (世界版)	Baku 女士大冒險 / 水之精靈 (世界版)	Taito Corporation Japan
liquidku	Baku 女士大冒險 / 水之精靈 (美版)	Baku 女士大冒險 / 水之精靈 (美版)	Taito America Corporation
mizubaku	Baku 女士大冒險 (日版)	Baku 女士大冒險 (日版)	Taito Corporation
quizhq	問答大本營 (日版)	問答大本營 (日版)	Taito Corporation
ssi	超級太空入侵者 '91 (世界版)	超級太空入侵者 '91 (世界版)	Taito Corporation Japan
majest12	超級太空入侵者 / Majestic Twelve - The Space Invaders Part IV (日版)	超級太空入侵者 / Majestic Twelve - The Space Invaders Part IV (日版)	Taito Corporation
gunfront	槍之國度 (世界版)	槍之國度 (世界版)	Taito Corporation Japan
gunfronj	槍之國度 (日版)	槍之國度 (日版)	Taito Corporation
growl	森林保護神 (世界版)	森林保護神 (世界版)	Taito Corporation Japan
growlu	森林保護神 (美版)	森林保護神 (美版)	Taito America Corporation
runark	森林保護神 / Runark (日版)	森林保護神 / Runark (日版)	Taito Corporation
mjnquest	麻雀探險 (日版)	麻雀探險 (日版)	Taito Corporation
mjnquesb	麻雀探險 (No Nudity)	麻雀探險 (No Nudity)	Taito Corporation
koshien	嗚呼榮光甲子園 (日版)	嗚呼榮光甲子園 (日版)	Taito Corporation
ninjak	忍者君 (世界版)	忍者君 (世界版)	Taito Corporation Japan
ninjakj	忍者君 (日版)	忍者君 (日版)	Taito Corporation
qzquest	問答搜查 - 英雄美女物語 (日版)	問答搜查 - 英雄美女物語 (日版)	Taito Corporation
qzchikyu	問答 地球防衛軍 (日版)	問答 地球防衛軍 (日版)	Taito Corporation
yesnoj	Yes/No 心電圖	Yes/No 心電圖	Taito Corporation
deadconx	死亡邊緣 (世界版)	死亡邊緣 (世界版)	Taito Corporation Japan
deadconj	死亡邊緣 (日版)	死亡邊緣 (日版)	Taito Corporation
dinorex	大恐龍格鬥技傳說 (世界版)	大恐龍格鬥技傳說 (世界版)	Taito Corporation Japan
dinorexj	大恐龍格鬥技傳說 (日版)	大恐龍格鬥技傳說 (日版)	Taito Corporation
dinorexu	大恐龍格鬥技傳說 (美版)	大恐龍格鬥技傳說 (美版)	Taito America Corporation
qjinsei	問答 人生劇場 (日版)	問答 人生劇場 (日版)	Taito Corporation
qcrayon	問答 蠟筆小新 (日版)	問答 蠟筆小新 (日版)	Taito Corporation
qcrayon2	蠟筆小新 (日版)	蠟筆小新 (日版)	Taito Corporation
arabianm	阿拉伯魔法 (世界版)	阿拉伯魔法 (世界版)	Taito Corporation Japan
arabiamj	阿拉伯魔法 (日版)	阿拉伯魔法 (日版)	Taito Corporation
arabiamu	阿拉伯魔法 (美版)	阿拉伯魔法 (美版)	Taito America Corporation
kaiserkn	王者鐵拳 (世界版)	王者鐵拳 (世界版)	Taito Corporation Japan
kaiserkj	王者鐵拳 (日版)	王者鐵拳 (日版)	Taito Corporation
gblchmp	王者鐵拳 / 世界冠軍 (美版)	王者鐵拳 / 世界冠軍 (美版)	Taito America Corporation
dankuga	王者鐵拳 / 斷仇牙 (Prototype)	王者鐵拳 / 斷仇牙 (Prototype)	Taito Corporation
dariusg	太空戰機外傳 - 銀鷹 (世界版)	太空戰機外傳 - 銀鷹 (世界版)	Taito Corporation Japan
dariusgj	太空戰機外傳 - 銀鷹 (日版)	太空戰機外傳 - 銀鷹 (日版)	Taito Corporation
dariusgu	太空戰機外傳 - 銀鷹 (美版)	太空戰機外傳 - 銀鷹 (美版)	Taito America Corporation
dariusgx	太空戰機外傳 - 銀鷹 (Extra Version) [Official Hack]	太空戰機外傳 - 銀鷹 (Extra Version) [Official Hack]	Taito Corporation
bublbob2	泡泡龍 2 (世界版)	泡泡龍 2 (世界版)	Taito Corporation Japan
bubsympe	泡泡龍 2 (歐洲版)	泡泡龍 2 (歐洲版)	Taito Corporation Japan
bubsympu	泡泡龍 2 (美版)	泡泡龍 2 (美版)	Taito America Corporation
bubsymph	泡泡龍 2 (日版)	泡泡龍 2 (日版)	Taito Corporation
spcinvdj	太空入侵者 DX (日版 F3 version)	太空入侵者 DX (日版 F3 version)	Taito Corporation
qtheater	問答劇場 - 第 3 物語 (日版)	問答劇場 - 第 3 物語 (日版)	Taito Corporation
elvactr	電梯大戰 2 (世界版)	電梯大戰 2 (世界版)	Taito Corporation Japan
elvactrj	電梯大戰 2 (日版)	電梯大戰 2 (日版)	Taito Corporation
elvact2u	電梯大戰 2 (美版)	電梯大戰 2 (美版)	Taito America Corporation
quizhuhu	森口博子問答 (日版)	森口博子問答 (日版)	Taito Corporation
pbobble2	泡泡龍解謎 2 (世界版)	泡泡龍解謎 2 (世界版)	Taito Corporation Japan
pbobbl2j	泡泡龍解謎 2 (日版)	泡泡龍解謎 2 (日版)	Taito Corporation
pbobbl2u	泡泡龍解謎 2 (美版)	泡泡龍解謎 2 (美版)	Taito America Corporation
pbobbl2x	泡泡龍解謎 2X (日版)	泡泡龍解謎 2X (日版)	Taito Corporation
gekirido	逆鱗彈 (日版)	逆鱗彈 (日版)	Taito Corporation
ktiger2	究極虎 2 (日版)	究極虎 2 (日版)	Taito Corporation
bubblem	泡泡龍 3 (世界版)	泡泡龍 3 (世界版)	Taito Corporation Japan
bubblemj	泡泡龍 3 (日版)	泡泡龍 3 (日版)	Taito Corporation
pbobble3	泡泡龍解謎 3 (世界版)	泡泡龍解謎 3 (世界版)	Taito Corporation
pbobbl3u	泡泡龍解謎 3 (美版)	泡泡龍解謎 3 (美版)	Taito Corporation
pbobbl3j	泡泡龍解謎 3 (日版)	泡泡龍解謎 3 (日版)	Taito Corporation
pbobble4	泡泡龍解謎 4 (世界版)	泡泡龍解謎 4 (世界版)	Taito Corporation
pbobbl4j	泡泡龍解謎 4 (日版)	泡泡龍解謎 4 (日版)	Taito Corporation
pbobbl4u	泡泡龍解謎 4 (美版)	泡泡龍解謎 4 (美版)	Taito Corporation
fshark	飛翔鮫 (世界版)	飛翔鮫 (世界版)	[Toaplan] Taito Corporation
skyshark	飛翔鮫 (美版)	飛翔鮫 (美版)	[Toaplan] Taito America Corporation (Romstar license)
hishouza	飛翔鮫 (日版)	飛翔鮫 (日版)	[Toaplan] Taito Corporation
fsharkbt	飛翔鮫 (bootleg)	飛翔鮫 (bootleg)	bootleg
twincobr	究極虎 (世界版)	究極虎 (世界版)	[Toaplan] Taito Corporation
twincobu	究極虎 (美版)	究極虎 (美版)	[Toaplan] Taito America Corporation (Romstar license)
ktiger	究極虎 (日版)	究極虎 (日版)	[Toaplan] Taito Corporation
rallybik	拉力摩托 / 衝刺野郎	拉力摩托 / 衝刺野郎	[Toaplan] Taito Corporation
truxton	達人	達人	[Toaplan] Taito Corporation
hellfire	地獄火	地獄火	Toaplan (Taito license)
hellfir1	地獄火 (1P Ver.)	地獄火 (1P Ver.)	Toaplan (Taito license)
zerowing	零式戰機	零式戰機	Toaplan
fireshrk	鮫! 鮫! 鮫! / Fire Shark	鮫! 鮫! 鮫! / Fire Shark	Toaplan
samesame	鮫! 鮫! 鮫!	鮫! 鮫! 鮫!	Toaplan
samesam2	鮫! 鮫! 鮫! (2P Ver.)	鮫! 鮫! 鮫! (2P Ver.)	Toaplan
outzone	異域戰將 (set 1)	異域戰將 (set 1)	Toaplan
outzonea	異域戰將 (set 2)	異域戰將 (set 2)	Toaplan
vimana	銀河戰機	銀河戰機	Toaplan
vimana1	銀河戰機 (old set)	銀河戰機 (old set)	Toaplan
vimanan	銀河戰機 (Nova Apparate GMBH & Co)	銀河戰機 (Nova Apparate GMBH & Co)	Toaplan (Nova Apparate GMBH & Co license)
snowbros	雪人兄弟 - 尼克和湯姆 (set 1)	雪人兄弟 - 尼克和湯姆 (set 1)	Toaplan
snowbroa	雪人兄弟 - 尼克和湯姆 (set 2)	雪人兄弟 - 尼克和湯姆 (set 2)	Toaplan
snowbrob	雪人兄弟 - 尼克和湯姆 (set 3)	雪人兄弟 - 尼克和湯姆 (set 3)	Toaplan
snowbroc	雪人兄弟 - 尼克和湯姆 (set 4)	雪人兄弟 - 尼克和湯姆 (set 4)	Toaplan
snowbroj	雪人兄弟 - 尼克和湯姆 (日版)	雪人兄弟 - 尼克和湯姆 (日版)	Toaplan
wintbob	雪人兄弟 - 尼克和湯姆 / The Winter Bobble	雪人兄弟 - 尼克和湯姆 / The Winter Bobble	bootleg
hyperpac	Hyper 小精靈	Hyper 小精靈	SemiCom
hyperpcb	Hyper 小精靈 (bootleg)	Hyper 小精靈 (bootleg)	bootleg
truxton2	達人王 II (日版)	達人王 II (日版)	Toaplan
pipibibs	皮皮與比比 / Pipi & Bibis / Whoopee!!	皮皮與比比 / Pipi & Bibis / Whoopee!!	Toaplan
whoopee	皮皮與比比 / Whoopee!! / Pipi & Bibis	皮皮與比比 / Whoopee!! / Pipi & Bibis	Toaplan
pipibibi	皮皮與比比 / Pipi & Bibis / Whoopee!! (bootleg ?)	皮皮與比比 / Pipi & Bibis / Whoopee!! (bootleg ?)	[Toaplan] Ryouta Kikaku
snowbro2	雪人兄弟 2 / Otenki Paradise	雪人兄弟 2 / Otenki Paradise	[Toaplan] Hanafram
sstriker	魔法大作戰 (世界版)	魔法大作戰 (世界版)	Raizing
sstrikra	魔法大作戰 (世界版, alt)	魔法大作戰 (世界版, alt)	Raizing
mahoudai	魔法大作戰 (日版)	魔法大作戰 (日版)	Raizing (Able license)
shippumd	疾風魔法大作戰 (日版)	疾風魔法大作戰 (日版)	Raizing / Eighting
kingdmgp	疾風魔法大作戰 (世界版)	疾風魔法大作戰 (世界版)	Raizing / Eighting
mazinger	無敵鐵金剛 Z	無敵鐵金剛 Z	Banpresto/Dynamic Pl. Toei Animation
donpachi	首領蜂 (美版)	首領蜂 (美版)	Atlus/Cave
donpachj	首領蜂 (日版)	首領蜂 (日版)	Atlus/Cave
donpachk	首領蜂 (韓國版)	首領蜂 (韓國版)	Atlus/Cave
metmqstr	隱忍 / Metamoqester	隱忍 / Metamoqester	Banpresto/Pandorabox
nmaster	隱忍 (日版)	隱忍 (日版)	Banpresto/Pandorabox
sailormn	美少女戰士 (95/03/22B)	美少女戰士 (95/03/22B)	Banpresto
sailormo	美少女戰士 (95/03/22)	美少女戰士 (95/03/22)	Banpresto
hotdogst	眩之風暴	眩之風暴	Marble
ddonpach	怒首領蜂 (國際版)	怒首領蜂 (國際版)	Atlus/Cave
ddonpchj	怒首領蜂 (日版)	怒首領蜂 (日版)	Atlus/Cave
dfeveron	彈銃 Feveron (日版)	彈銃 Feveron (日版)	Cave (Nihon System license)
feversos	彈銃 Feveron / Fever SOS (國際版)	彈銃 Feveron / Fever SOS (國際版)	Cave (Nihon System license)
uopoko	小貓釣魚 (日版)	小貓釣魚 (日版)	Cave (Jaleco license)
guwange	獄門山物語 (日版)	獄門山物語 (日版)	Atlus/Cave
gaia	征戰者	征戰者	Noise Factory
sonofphx	鳳凰之子	鳳凰之子	Associated Overseas MFR, Inc
repulse	鳳凰之子 / Repulse	鳳凰之子 / Repulse	Sega
99lstwar	鳳凰之子 / '99: The Last War	鳳凰之子 / '99: The Last War	Proma
99lstwra	鳳凰之子 / '99: The Last War (alternate)	鳳凰之子 / '99: The Last War (alternate)	Proma
srdmissn	S.R.D. 任務	S.R.D. 任務	Taito Corporation
airwolf	天狼	天狼	Kyugo
skywolf	天狼 / 空狼 (set 1)	天狼 / 空狼 (set 1)	bootleg
skywolf2	天狼 / 空狼 (set 2)	天狼 / 空狼 (set 2)	bootleg
sonson	西遊記	西遊記	Capcom
sonsonj	西遊記 (日版)	西遊記 (日版)	Capcom
commando	戰場之狼 / Commando (世界版)	戰場之狼 / Commando (世界版)	Capcom
commandu	戰場之狼 / Commando (美版)	戰場之狼 / Commando (美版)	Capcom (Data East USA license)
commandj	戰場之狼	戰場之狼	Capcom
sinvasn	戰場之狼 / Space Invasion (歐洲版)	戰場之狼 / Space Invasion (歐洲版)	Capcom
sinvasnb	戰場之狼 / Space Invasion (bootleg)	戰場之狼 / Space Invasion (bootleg)	bootleg
gng	魔界村 (世界版? set 1)	魔界村 (世界版? set 1)	Capcom
gnga	魔界村 (世界版? set 2)	魔界村 (世界版? set 2)	Capcom
gngt	魔界村 (美版)	魔界村 (美版)	Capcom (Taito America license)
makaimur	魔界村 (日版)	魔界村 (日版)	Capcom
makaimuc	魔界村 (日版 Revision C)	魔界村 (日版 Revision C)	Capcom
makaimug	魔界村 (日版 Revision G)	魔界村 (日版 Revision G)	Capcom
gunsmoke	荒野大鏢客 (世界版)	荒野大鏢客 (世界版)	Capcom
gunsmoku	荒野大鏢客 (美版 set 1)	荒野大鏢客 (美版 set 1)	Capcom (Romstar license)
gunsmoka	荒野大鏢客 (美版 set 2)	荒野大鏢客 (美版 set 2)	Capcom (Romstar license)
gunsmokj	荒野大鏢客 (日版)	荒野大鏢客 (日版)	Capcom
trojan	鬥者輓歌 / 特洛伊 (美版)	鬥者輓歌 / 特洛伊 (美版)	Capcom
trojanr	鬥者輓歌 / 特洛伊 (Romstar)	鬥者輓歌 / 特洛伊 (Romstar)	Capcom (Romstar license)
trojanj	鬥者輓歌 (日版)	鬥者輓歌 (日版)	Capcom
lwings	翼人 (美版 set 1)	翼人 (美版 set 1)	Capcom
lwings2	翼人 (美版 set 2)	翼人 (美版 set 2)	Capcom
lwingsjp	翼人 (日版)	翼人 (日版)	Capcom
avengers	必殺 無賴拳 (美版 set 1)	必殺 無賴拳 (美版 set 1)	Capcom
avenger2	必殺 無賴拳 (美版 set 2)	必殺 無賴拳 (美版 set 2)	Capcom
buraiken	必殺 無賴拳 (日版)	必殺 無賴拳 (日版)	Capcom
bionicc	生化指令 (美版 set 1)	生化指令 (美版 set 1)	Capcom
bionicc2	生化指令 (美版 set 2)	生化指令 (美版 set 2)	Capcom
topsecrt	最高機密 (日版)	最高機密 (日版)	Capcom
1943	1943 - 中途島海戰 (美版)	1943 - 中途島海戰 (美版)	Capcom
1943j	1943 - 中途島海戰 (日版)	1943 - 中途島海戰 (日版)	Capcom
blktiger	黑虎	黑虎	Capcom
bktigerb	黑虎 (bootleg)	黑虎 (bootleg)	bootleg
blkdrgon	黑虎 / 黑龍	黑虎 / 黑龍	Capcom
blkdrgnb	黑虎 / 黑龍 (bootleg)	黑虎 / 黑龍 (bootleg)	bootleg
sf	快打旋風 (世界版)	快打旋風 (世界版)	Capcom
sfus	快打旋風 (美版)	快打旋風 (美版)	Capcom
sfjp	快打旋風 (日版)	快打旋風 (日版)	Capcom
sfp	快打旋風 (prototype)	快打旋風 (prototype)	Capcom
tigeroad	虎之道 (美版)	虎之道 (美版)	Capcom (Romstar license)
toramich	虎之道 (日版)	虎之道 (日版)	Capcom
tigerodb	虎之道 (美版 bootleg)	虎之道 (美版 bootleg)	bootleg
f1dream	F-1 之夢	F-1 之夢	Capcom (Romstar license)
f1dreamb	F-1 之夢 (bootleg)	F-1 之夢 (bootleg)	bootleg
1943kai	1943 改: 中途島海戰 (日版)	1943 改: 中途島海戰 (日版)	Capcom
lastduel	決戰 (美版 set 1)	決戰 (美版 set 1)	Capcom
lstduela	決戰 (美版 set 2)	決戰 (美版 set 2)	Capcom
lstduelb	決戰 (bootleg)	決戰 (bootleg)	bootleg
madgear	瘋狂機車 (美版)	瘋狂機車 (美版)	Capcom
madgearj	瘋狂機車 (日版)	瘋狂機車 (日版)	Capcom
ledstorm	瘋狂機車 / Led Storm (美版)	瘋狂機車 / Led Storm (美版)	Capcom
forgottn	世界末日 / 失落的世界 (美版)	世界末日 / 失落的世界 (美版)	Capcom
lostwrld	世界末日 / 失落的世界 (日版)	世界末日 / 失落的世界 (日版)	Capcom
ghouls	大魔界村 (世界版)	大魔界村 (世界版)	Capcom
ghoulsu	大魔界村 (美版)	大魔界村 (美版)	Capcom
daimakai	大魔界村 (日版)	大魔界村 (日版)	Capcom
strider	出擊飛龍 (美版 set 1)	出擊飛龍 (美版 set 1)	Capcom
stridrua	出擊飛龍 (美版 set 2)	出擊飛龍 (美版 set 2)	Capcom
striderj	出擊飛龍 (日版 set 1)	出擊飛龍 (日版 set 1)	Capcom
stridrja	出擊飛龍 (日版 set 2)	出擊飛龍 (日版 set 2)	Capcom
willow	威洛之旅 (美版)	威洛之旅 (美版)	Capcom
willowj	威洛之旅 (日版, 日文)	威洛之旅 (日版, 日文)	Capcom
willowje	威洛之旅 (日版, 英文)	威洛之旅 (日版, 英文)	Capcom
unsquad	戰區 88 (美版)	戰區 88 (美版)	Capcom
area88	戰區 88 (日版)	戰區 88 (日版)	Capcom
ffight	街頭快打 (世界版)	街頭快打 (世界版)	Capcom
ffightu	街頭快打 (美版 900112)	街頭快打 (美版 900112)	Capcom
ffightj	街頭快打 (日版)	街頭快打 (日版)	Capcom
ffightj1	街頭快打 (日版 900305)	街頭快打 (日版 900305)	Capcom
1941	1941 - 反擊 (世界版)	1941 - 反擊 (世界版)	Capcom
1941j	1941 - 反擊 (日版)	1941 - 反擊 (日版)	Capcom
mercs	戰場之狼 II (世界版 900302)	戰場之狼 II (世界版 900302)	Capcom
mercsu	戰場之狼 II (美版 900302)	戰場之狼 II (美版 900302)	Capcom
mercsua	戰場之狼 II (美版 900608)	戰場之狼 II (美版 900608)	Capcom
mercsj	戰場之狼 II (日版 900302)	戰場之狼 II (日版 900302)	Capcom
mtwins	雙麟兒 (世界版 900619)	雙麟兒 (世界版 900619)	Capcom
chikij	雙麟兒 (日版 900619)	雙麟兒 (日版 900619)	Capcom
msword	魔劍 (世界版 900725)	魔劍 (世界版 900725)	Capcom
mswordr1	魔劍 (世界版 900623)	魔劍 (世界版 900623)	Capcom
mswordu	魔劍 (美版 900725)	魔劍 (美版 900725)	Capcom
mswordj	魔劍 (日版 900623)	魔劍 (日版 900623)	Capcom
cawing	美國海軍 (世界版 901012)	美國海軍 (世界版 901012)	Capcom
cawingu	美國海軍 (美版 901012)	美國海軍 (美版 901012)	Capcom
cawingj	美國海軍 (日版 901012)	美國海軍 (日版 901012)	Capcom
nemo	夢幻冒險 (世界版 901130)	夢幻冒險 (世界版 901130)	Capcom
nemoj	夢幻冒險 (日版 901120)	夢幻冒險 (日版 901120)	Capcom
sf2	快打旋風 II (世界版 910522)	快打旋風 II (世界版 910522)	Capcom
sf2eb	快打旋風 II (世界版 910214)	快打旋風 II (世界版 910214)	Capcom
sf2ua	快打旋風 II (美版 910206)	快打旋風 II (美版 910206)	Capcom
sf2ub	快打旋風 II (美版 910214)	快打旋風 II (美版 910214)	Capcom
sf2ud	快打旋風 II (美版 910318)	快打旋風 II (美版 910318)	Capcom
sf2ue	快打旋風 II (美版 910228)	快打旋風 II (美版 910228)	Capcom
sf2uf	快打旋風 II (美版 910411)	快打旋風 II (美版 910411)	Capcom
sf2ui	快打旋風 II (美版 910522)	快打旋風 II (美版 910522)	Capcom
sf2uk	快打旋風 II (美版 911101)	快打旋風 II (美版 911101)	Capcom
sf2j	快打旋風 II (日版 911210)	快打旋風 II (日版 911210)	Capcom
sf2ja	快打旋風 II (日版 910214)	快打旋風 II (日版 910214)	Capcom
sf2jc	快打旋風 II (日版 910306)	快打旋風 II (日版 910306)	Capcom
3wonders	神奇三合一 (世界版 910520)	神奇三合一 (世界版 910520)	Capcom
3wonderu	神奇三合一 (美版 910520)	神奇三合一 (美版 910520)	Capcom
wonder3	神奇三合一 (日版 910520)	神奇三合一 (日版 910520)	Capcom
kod	龍王 (世界版 910711)	龍王 (世界版 910711)	Capcom
kodu	龍王 (美版 910910)	龍王 (美版 910910)	Capcom
kodj	龍王 (日版 910805)	龍王 (日版 910805)	Capcom
kodb	龍王 (bootleg)	龍王 (bootleg)	Capcom
captcomm	上尉密令 (世界版 911014)	上尉密令 (世界版 911014)	Capcom
captcomu	上尉密令 (美版 910928)	上尉密令 (美版 910928)	Capcom
captcomj	上尉密令 (日版 911202)	上尉密令 (日版 911202)	Capcom
knights	圓桌武士 (世界版 911127)	圓桌武士 (世界版 911127)	Capcom
knightsu	圓桌武士 (美版 911127)	圓桌武士 (美版 911127)	Capcom
knightsj	圓桌武士 (日版 911127)	圓桌武士 (日版 911127)	Capcom
sf2ce	快打旋風 II' - 四大天王 (世界版 920313)	快打旋風 II' - 四大天王 (世界版 920313)	Capcom
sf2ceua	快打旋風 II' - 四大天王 (美版 920313)	快打旋風 II' - 四大天王 (美版 920313)	Capcom
sf2ceub	快打旋風 II' - 四大天王 (美版 920513)	快打旋風 II' - 四大天王 (美版 920513)	Capcom
sf2ceuc	快打旋風 II' - 四大天王 (美版 920803)	快打旋風 II' - 四大天王 (美版 920803)	Capcom
sf2cej	快打旋風 II' - 四大天王 (日版 920513)	快打旋風 II' - 四大天王 (日版 920513)	Capcom
sf2rb	快打旋風 II' - 四大天王 (彩虹版 set 1)	快打旋風 II' - 四大天王 (彩虹版 set 1)	bootleg
sf2rb2	快打旋風 II' - 四大天王 (彩虹版 set 2)	快打旋風 II' - 四大天王 (彩虹版 set 2)	bootleg
sf2red	快打旋風 II' - 四大天王 (赤色波動)	快打旋風 II' - 四大天王 (赤色波動)	bootleg
sf2v004	快打旋風 II! - 四大天王 (V004)	快打旋風 II! - 四大天王 (V004)	bootleg
sf2accp2	快打旋風 II' - 四大天王 (加速版 Pt.II)	快打旋風 II' - 四大天王 (加速版 Pt.II)	bootleg
sf2m1	快打旋風 II' - 四大天王 (M1)	快打旋風 II' - 四大天王 (M1)	bootleg
sf2m2	快打旋風 II' - 四大天王 (M2)	快打旋風 II' - 四大天王 (M2)	bootleg
sf2m3	快打旋風 II' - 四大天王 (M3)	快打旋風 II' - 四大天王 (M3)	bootleg
sf2m4	快打旋風 II' - 四大天王 (M4)	快打旋風 II' - 四大天王 (M4)	bootleg
sf2m5	快打旋風 II' - 四大天王 (M5)	快打旋風 II' - 四大天王 (M5)	bootleg
sf2m6	快打旋風 II' - 四大天王 (M6)	快打旋風 II' - 四大天王 (M6)	bootleg
sf2m7	快打旋風 II' - 四大天王 (M7)	快打旋風 II' - 四大天王 (M7)	bootleg
sf2yyc	快打旋風 II' - 四大天王 (YYC)	快打旋風 II' - 四大天王 (YYC)	bootleg
sf2koryu	快打旋風 II' - 四大天王 (降龍)	快打旋風 II' - 四大天王 (降龍)	bootleg
varth	雷電風暴 / 威虎戰機 (世界版 920612)	雷電風暴 / 威虎戰機 (世界版 920612)	Capcom
varthu	雷電風暴 / 威虎戰機 (美版 920612)	雷電風暴 / 威虎戰機 (美版 920612)	Capcom (Romstar license)
varthj	雷電風暴 / 威虎戰機 (日版 920714)	雷電風暴 / 威虎戰機 (日版 920714)	Capcom
cworld2j	卡普空問答 2 (日版 920611)	卡普空問答 2 (日版 920611)	Capcom
wof	吞食天地 II - 赤壁之戰(世界版 921002)	吞食天地 II - 赤壁之戰(世界版 921002)	Capcom
wofa	吞食天地 II / 三國誌 II (亞洲版 921005)	吞食天地 II / 三國誌 II (亞洲版 921005)	Capcom
wofu	吞食天地 II - 赤壁之戰 (美版 921031)	吞食天地 II - 赤壁之戰 (美版 921031)	Capcom
wofj	吞食天地 II - 赤壁之戰 (日版 921031)	吞食天地 II - 赤壁之戰 (日版 921031)	Capcom
sf2hf	快打旋風 II' - 激戰 (世界版 921209)	快打旋風 II' - 激戰 (世界版 921209)	Capcom
sf2t	快打旋風 II' - 激戰 (美版 921209)	快打旋風 II' - 激戰 (美版 921209)	Capcom
sf2tj	快打旋風 II' Turbo - 激戰 (日版 921209)	快打旋風 II' Turbo - 激戰 (日版 921209)	Capcom
dino	恐龍新世紀 (世界版 930201)	恐龍新世紀 (世界版 930201)	Capcom
dinou	恐龍新世紀 (美版 930201)	恐龍新世紀 (美版 930201)	Capcom
dinoj	恐龍新世紀 (日版 930201)	恐龍新世紀 (日版 930201)	Capcom
punisher	毀滅者 (世界版 930422)	毀滅者 (世界版 930422)	Capcom
punishru	毀滅者 (美版 930422)	毀滅者 (美版 930422)	Capcom
punishrj	毀滅者 (日版 930422)	毀滅者 (日版 930422)	Capcom
slammast	摔角霸王 (世界版 930713)	摔角霸王 (世界版 930713)	Capcom
slammasu	摔角霸王 (美版 930713)	摔角霸王 (美版 930713)	Capcom
mbomberj	摔角霸王 / Muscle Bomber (日版 930713)	摔角霸王 / Muscle Bomber (日版 930713)	Capcom
mbombrd	摔角霸王 / Muscle Bomber Duo (世界版 931206)	摔角霸王 / Muscle Bomber Duo (世界版 931206)	Capcom
mbombrdj	摔角霸王 / Muscle Bomber Duo (日版 931206)	摔角霸王 / Muscle Bomber Duo (日版 931206)	Capcom
pnickj	寶石方塊 (日版 940608)	寶石方塊 (日版 940608)	Compile (Capcom license)
qad	龍之謎題 (美版 920701)	龍之謎題 (美版 920701)	Capcom
qadj	龍之謎題 (日版 940921)	龍之謎題 (日版 940921)	Capcom
qtono2	問答 殿樣之野望 2 全國版 (日版 950123)	問答 殿樣之野望 2 全國版 (日版 950123)	Capcom
pang3	魔法氣泡! 3 - 怪盜的華麗午後 (歐洲版 950511)	魔法氣泡! 3 - 怪盜的華麗午後 (歐洲版 950511)	Mitchell
pang3j	魔法氣泡! 3 - 怪盜的華麗午後 (日版 950511)	魔法氣泡! 3 - 怪盜的華麗午後 (日版 950511)	Mitchell
megaman	洛克人 - 力量對決 (CPS1 亞洲版 951006)	洛克人 - 力量對決 (CPS1 亞洲版 951006)	Capcom
rockmanj	洛克人 - 力量對決 (CPS1 日版 950922)	洛克人 - 力量對決 (CPS1 日版 950922)	Capcom
dinoh	恐龍新世紀 (hack)	恐龍新世紀 (hack)	hack
sfzch	少年快打 (CPS Changer 日版 951020)	少年快打 (CPS Changer 日版 951020)	Capcom
sfach	少年快打 (Publicity 美版 950727)	少年快打 (Publicity 美版 950727)	Capcom
knightsh	圓桌武士 (hack)	圓桌武士 (hack)	hack
sf2toryu	快打旋風 II' - 四大天王 (屠龍 set 1)	快打旋風 II' - 四大天王 (屠龍 set 1)	bootleg
sf2tory2	快打旋風 II' - 四大天王 (屠龍 set 2)	快打旋風 II' - 四大天王 (屠龍 set 2)	bootleg
ssf2	超級快打旋風 2: 新挑戰者 (世界版 930911)	超級快打旋風 2: 新挑戰者 (世界版 930911)	Capcom
ssf2u	超級快打旋風 2: 新挑戰者 (美版 930911)	超級快打旋風 2: 新挑戰者 (美版 930911)	Capcom
ssf2a	超級快打旋風 2: 新挑戰者 (亞洲版 931005)	超級快打旋風 2: 新挑戰者 (亞洲版 931005)	Capcom
ssf2ar1	超級快打旋風 2: 新挑戰者 (亞洲版 930914)	超級快打旋風 2: 新挑戰者 (亞洲版 930914)	Capcom
ssf2j	超級快打旋風 2: 新挑戰者 (日版 931005)	超級快打旋風 2: 新挑戰者 (日版 931005)	Capcom
ssf2jr1	超級快打旋風 2: 新挑戰者 (日版 930911)	超級快打旋風 2: 新挑戰者 (日版 930911)	Capcom
ssf2jr2	超級快打旋風 2: 新挑戰者 (日版 930910)	超級快打旋風 2: 新挑戰者 (日版 930910)	Capcom
ssf2tb	超級快打旋風 2: 聯賽 (世界版 931119)	超級快打旋風 2: 聯賽 (世界版 931119)	Capcom
ssf2tbj	超級快打旋風 2: 聯賽 (日版 930910)	超級快打旋風 2: 聯賽 (日版 930910)	Capcom
ecofghtr	扭轉戰鬥機 (世界版 931203)	扭轉戰鬥機 (世界版 931203)	Capcom
ecofghta	扭轉戰鬥機 (亞洲版 931203)	扭轉戰鬥機 (亞洲版 931203)	Capcom
uecology	扭轉戰鬥機 (日版 931203)	扭轉戰鬥機 (日版 931203)	Capcom
ddtod	地獄神龍 / 龍與地下城: 毀滅之塔 (歐洲版 940412)	地獄神龍 / 龍與地下城: 毀滅之塔 (歐洲版 940412)	Capcom
ddtodr1	地獄神龍 / 龍與地下城: 毀滅之塔 (歐洲版 940113)	地獄神龍 / 龍與地下城: 毀滅之塔 (歐洲版 940113)	Capcom
ddtodu	地獄神龍 / 龍與地下城: 毀滅之塔 (美版 940125)	地獄神龍 / 龍與地下城: 毀滅之塔 (美版 940125)	Capcom
ddtodur1	地獄神龍 / 龍與地下城: 毀滅之塔 (美版 940113)	地獄神龍 / 龍與地下城: 毀滅之塔 (美版 940113)	Capcom
ddtodj	地獄神龍 / 龍與地下城: 毀滅之塔 (日版 940125)	地獄神龍 / 龍與地下城: 毀滅之塔 (日版 940125)	Capcom
ddtodjr1	地獄神龍 / 龍與地下城: 毀滅之塔 (日版 940113)	地獄神龍 / 龍與地下城: 毀滅之塔 (日版 940113)	Capcom
ddtoda	地獄神龍 / 龍與地下城: 毀滅之塔 (亞洲版 940113)	地獄神龍 / 龍與地下城: 毀滅之塔 (亞洲版 940113)	Capcom
ddtodh	地獄神龍 / 龍與地下城: 毀滅之塔 (西班牙版 940125)	地獄神龍 / 龍與地下城: 毀滅之塔 (西班牙版 940125)	Capcom
ssf2t	超級快打旋風 2 Turbo (世界版 940223)	超級快打旋風 2 Turbo (世界版 940223)	Capcom
ssf2tu	超級快打旋風 2 Turbo (美版 940323)	超級快打旋風 2 Turbo (美版 940323)	Capcom
ssf2tur1	超級快打旋風 2 Turbo (美版 940223)	超級快打旋風 2 Turbo (美版 940223)	Capcom
ssf2ta	超級快打旋風 2 Turbo (亞洲版 940223)	超級快打旋風 2 Turbo (亞洲版 940223)	Capcom
ssf2xj	超級快打旋風 2 X (日版 940223)	超級快打旋風 2 X (日版 940223)	Capcom
avsp	異形 Vs. 終極戰士 (歐洲版 940520)	異形 Vs. 終極戰士 (歐洲版 940520)	Capcom
avspu	異形 Vs. 終極戰士 (美版 940520)	異形 Vs. 終極戰士 (美版 940520)	Capcom
avspj	異形 Vs. 終極戰士 (日版 940520)	異形 Vs. 終極戰士 (日版 940520)	Capcom
avspa	異形 Vs. 終極戰士 (亞洲版 940520)	異形 Vs. 終極戰士 (亞洲版 940520)	Capcom
avsph	異形 Vs. 終極戰士 (西班牙版 940520)	異形 Vs. 終極戰士 (西班牙版 940520)	Capcom
dstlk	魔域幽靈: 午夜鬥士 (歐洲版 940705)	魔域幽靈: 午夜鬥士 (歐洲版 940705)	Capcom
dstlku	魔域幽靈: 午夜鬥士 (美版 940818)	魔域幽靈: 午夜鬥士 (美版 940818)	Capcom
dstlkur1	魔域幽靈: 午夜鬥士 (美版 940705)	魔域幽靈: 午夜鬥士 (美版 940705)	Capcom
dstlka	魔域幽靈: 午夜鬥士 (亞洲版 940705)	魔域幽靈: 午夜鬥士 (亞洲版 940705)	Capcom
vampj	魔域幽靈: 午夜鬥士 (日版 940705)	魔域幽靈: 午夜鬥士 (日版 940705)	Capcom
vampja	魔域幽靈: 午夜鬥士 (日版 940705 alt)	魔域幽靈: 午夜鬥士 (日版 940705 alt)	Capcom
vampjr1	魔域幽靈: 午夜鬥士 (日版 940630)	魔域幽靈: 午夜鬥士 (日版 940630)	Capcom
ringdest	超級摔角霸王: 連環爆裂 (歐洲版 940902)	超級摔角霸王: 連環爆裂 (歐洲版 940902)	Capcom
smbomb	超級摔角霸王: 連環爆裂 (日版 940831)	超級摔角霸王: 連環爆裂 (日版 940831)	Capcom
smbombr1	超級摔角霸王: 連環爆裂 (日版 940808)	超級摔角霸王: 連環爆裂 (日版 940808)	Capcom
armwar	裝甲戰士 (歐洲版 941024)	裝甲戰士 (歐洲版 941024)	Capcom
armwarr1	裝甲戰士 (歐洲版 941011)	裝甲戰士 (歐洲版 941011)	Capcom
armwaru	裝甲戰士 (美版 941024)	裝甲戰士 (美版 941024)	Capcom
pgear	裝甲戰士 (日版 941024)	裝甲戰士 (日版 941024)	Capcom
pgearr1	裝甲戰士 (日版 940916)	裝甲戰士 (日版 940916)	Capcom
armwara	裝甲戰士 (亞洲版 940920)	裝甲戰士 (亞洲版 940920)	Capcom
xmcota	特異功能組: 原子人 (歐洲版 950105)	特異功能組: 原子人 (歐洲版 950105)	Capcom
xmcotau	特異功能組: 原子人 (美版 950105)	特異功能組: 原子人 (美版 950105)	Capcom
xmcotah	特異功能組: 原子人 (西班牙版 950331)	特異功能組: 原子人 (西班牙版 950331)	Capcom
xmcotaj	特異功能組: 原子人 (日版 941219)	特異功能組: 原子人 (日版 941219)	Capcom
xmcotaj1	特異功能組: 原子人 (日版 941217)	特異功能組: 原子人 (日版 941217)	Capcom
xmcotaa	特異功能組: 原子人 (亞洲版 941217)	特異功能組: 原子人 (亞洲版 941217)	Capcom
xmcotajr	特異功能組: 原子人 (日版 941208 rent version)	特異功能組: 原子人 (日版 941208 rent version)	Capcom
nwarr	魔域幽靈: 惡魔的復仇 (美版 950406)	魔域幽靈: 惡魔的復仇 (美版 950406)	Capcom
nwarrh	魔域幽靈: 惡魔的復仇 (西班牙版 950403)	魔域幽靈: 惡魔的復仇 (西班牙版 950403)	Capcom
nwarrb	魔域幽靈: 惡魔的復仇 (巴西版 950403)	魔域幽靈: 惡魔的復仇 (巴西版 950403)	Capcom
vhuntj	魔域幽靈: 惡魔的復仇 (日版 950316)	魔域幽靈: 惡魔的復仇 (日版 950316)	Capcom
vhuntjr1	魔域幽靈: 惡魔的復仇 (日版 950307)	魔域幽靈: 惡魔的復仇 (日版 950307)	Capcom
vhuntjr2	魔域幽靈: 惡魔的復仇 (日版 950302)	魔域幽靈: 惡魔的復仇 (日版 950302)	Capcom
cybots	機甲格鬥 (歐洲版 950424)	機甲格鬥 (歐洲版 950424)	Capcom
cybotsu	機甲格鬥 (美版 950424)	機甲格鬥 (美版 950424)	Capcom
cybotsj	機甲格鬥 (日版 950420)	機甲格鬥 (日版 950420)	Capcom
sfa	少年快打 (歐洲版 950727)	少年快打 (歐洲版 950727)	Capcom
sfar1	少年快打 (歐洲版 950718)	少年快打 (歐洲版 950718)	Capcom
sfar2	少年快打 (歐洲版 950627)	少年快打 (歐洲版 950627)	Capcom
sfar3	少年快打 (歐洲版 950605)	少年快打 (歐洲版 950605)	Capcom
sfau	少年快打 (美版 950627)	少年快打 (美版 950627)	Capcom
sfza	少年快打 (亞洲版 950627)	少年快打 (亞洲版 950627)	Capcom
sfzj	少年快打 (日版 950727)	少年快打 (日版 950727)	Capcom
sfzjr1	少年快打 (日版 950627)	少年快打 (日版 950627)	Capcom
sfzjr2	少年快打 (日版 950605)	少年快打 (日版 950605)	Capcom
sfzh	少年快打 (西班牙版 950627)	少年快打 (西班牙版 950627)	Capcom
sfzb	少年快打 (巴西版 951109)	少年快打 (巴西版 951109)	Capcom
sfzbr1	少年快打 (巴西版 950727)	少年快打 (巴西版 950727)	Capcom
rckmanj	洛克人: 力量對決 (日版 950922)	洛克人: 力量對決 (日版 950922)	Capcom
msh	美國超人 (歐洲版 951024)	美國超人 (歐洲版 951024)	Capcom
mshu	美國超人 (美版 951024)	美國超人 (美版 951024)	Capcom
mshj	美國超人 (日版 951117)	美國超人 (日版 951117)	Capcom
mshjr1	美國超人 (日版 951024)	美國超人 (日版 951024)	Capcom
msha	美國超人 (亞洲版 951024)	美國超人 (亞洲版 951024)	Capcom
mshh	美國超人 (西班牙版 951117)	美國超人 (西班牙版 951117)	Capcom
mshb	美國超人 (巴西版 951117)	美國超人 (巴西版 951117)	Capcom
19xx	19XX: 命運否決戰 (美版 951207)	19XX: 命運否決戰 (美版 951207)	Capcom
19xxj	19XX: 命運否決戰 (日版 951225)	19XX: 命運否決戰 (日版 951225)	Capcom
19xxjr1	19XX: 命運否決戰 (日版 951207)	19XX: 命運否決戰 (日版 951207)	Capcom
19xxa	19XX: 命運否決戰 (亞洲版 951207)	19XX: 命運否決戰 (亞洲版 951207)	Capcom
19xxh	19XX: 命運否決戰 (西班牙版 951218)	19XX: 命運否決戰 (西班牙版 951218)	Capcom
ddsom	地獄神龍 2 / 龍與地下城: 暗黑秘影 (歐洲版 960619)	地獄神龍 2 / 龍與地下城: 暗黑秘影 (歐洲版 960619)	Capcom
ddsomr1	地獄神龍 2 / 龍與地下城: 暗黑秘影 (歐洲版 960223)	地獄神龍 2 / 龍與地下城: 暗黑秘影 (歐洲版 960223)	Capcom
ddsomr2	地獄神龍 2 / 龍與地下城: 暗黑秘影 (歐洲版 960209)	地獄神龍 2 / 龍與地下城: 暗黑秘影 (歐洲版 960209)	Capcom
ddsomu	地獄神龍 2 / 龍與地下城: 暗黑秘影 (美版 960619)	地獄神龍 2 / 龍與地下城: 暗黑秘影 (美版 960619)	Capcom
ddsomur1	地獄神龍 2 / 龍與地下城: 暗黑秘影 (美版 960209)	地獄神龍 2 / 龍與地下城: 暗黑秘影 (美版 960209)	Capcom
ddsomjr1	地獄神龍 2 / 龍與地下城: 暗黑秘影 (日版 960206)	地獄神龍 2 / 龍與地下城: 暗黑秘影 (日版 960206)	Capcom
ddsomj	地獄神龍 2 / 龍與地下城: 暗黑秘影 (日版 960619)	地獄神龍 2 / 龍與地下城: 暗黑秘影 (日版 960619)	Capcom
ddsoma	地獄神龍 2 / 龍與地下城: 暗黑秘影 (亞洲版 960619)	地獄神龍 2 / 龍與地下城: 暗黑秘影 (亞洲版 960619)	Capcom
sfa2	少年快打 2 (美版 960306)	少年快打 2 (美版 960306)	Capcom
sfz2j	少年快打 2 (日版 960227)	少年快打 2 (日版 960227)	Capcom
sfz2a	少年快打 2 (亞洲版 960227)	少年快打 2 (亞洲版 960227)	Capcom
sfz2b	少年快打 2 (巴西版 960531)	少年快打 2 (巴西版 960531)	Capcom
sfz2br1	少年快打 2 (巴西版 960304)	少年快打 2 (巴西版 960304)	Capcom
sfz2h	少年快打 2 (西班牙版 960304)	少年快打 2 (西班牙版 960304)	Capcom
sfz2n	少年快打 2 (大洋洲版 960229)	少年快打 2 (大洋洲版 960229)	Capcom
spf2t	超級快打方塊 2 Turbo (美版 960620)	超級快打方塊 2 Turbo (美版 960620)	Capcom
spf2xj	超級快打方塊 2 X (日版 960531)	超級快打方塊 2 X (日版 960531)	Capcom
spf2ta	超級快打方塊 2 Turbo (亞洲版 960529)	超級快打方塊 2 Turbo (亞洲版 960529)	Capcom
qndream	問答 Nanairo 之夢: 虹色町的奇跡 (日版 960826)	問答 Nanairo 之夢: 虹色町的奇跡 (日版 960826)	Capcom
megaman2	洛克人 2: 力量對決 (美版 960708)	洛克人 2: 力量對決 (美版 960708)	Capcom
megamn2a	洛克人 2: 力量對決 (亞洲版 960708)	洛克人 2: 力量對決 (亞洲版 960708)	Capcom
rckman2j	洛克人 2: 力量對決 (日版 960708)	洛克人 2: 力量對決 (日版 960708)	Capcom
sfz2aj	少年快打 2 Alpha (日版 960805)	少年快打 2 Alpha (日版 960805)	Capcom
sfz2ah	少年快打 2 Alpha (西班牙版 960813)	少年快打 2 Alpha (西班牙版 960813)	Capcom
sfz2ab	少年快打 2 Alpha (巴西版 960813)	少年快打 2 Alpha (巴西版 960813)	Capcom
sfz2aa	少年快打 2 Alpha (亞洲版 960826)	少年快打 2 Alpha (亞洲版 960826)	Capcom
xmvsf	特異功能組 Vs. 快打旋風 (歐洲版 960910)	特異功能組 Vs. 快打旋風 (歐洲版 960910)	Capcom
xmvsfu	特異功能組 Vs. 快打旋風 (美版 961023)	特異功能組 Vs. 快打旋風 (美版 961023)	Capcom
xmvsfur1	特異功能組 Vs. 快打旋風 (美版 961004)	特異功能組 Vs. 快打旋風 (美版 961004)	Capcom
xmvsfj	特異功能組 Vs. 快打旋風 (日版 961004)	特異功能組 Vs. 快打旋風 (日版 961004)	Capcom
xmvsfjr1	特異功能組 Vs. 快打旋風 (日版 960910)	特異功能組 Vs. 快打旋風 (日版 960910)	Capcom
xmvsfjr2	特異功能組 Vs. 快打旋風 (日版 960909)	特異功能組 Vs. 快打旋風 (日版 960909)	Capcom
xmvsfa	特異功能組 Vs. 快打旋風 (亞洲版 961023)	特異功能組 Vs. 快打旋風 (亞洲版 961023)	Capcom
xmvsfar1	特異功能組 Vs. 快打旋風 (亞洲版 960919)	特異功能組 Vs. 快打旋風 (亞洲版 960919)	Capcom
xmvsfh	特異功能組 Vs. 快打旋風 (西班牙版 961004)	特異功能組 Vs. 快打旋風 (西班牙版 961004)	Capcom
xmvsfb	特異功能組 Vs. 快打旋風 (巴西版 961023)	特異功能組 Vs. 快打旋風 (巴西版 961023)	Capcom
batcir	戰鬥回路 (歐洲版 970319)	戰鬥回路 (歐洲版 970319)	Capcom
batcirj	戰鬥回路 (日版 970319)	戰鬥回路 (日版 970319)	Capcom
batcira	戰鬥回路 (亞洲版 970319)	戰鬥回路 (亞洲版 970319)	Capcom
vsav	魔域幽靈: 惡魔救世主 (歐洲版 970519)	魔域幽靈: 惡魔救世主 (歐洲版 970519)	Capcom
vsavu	魔域幽靈: 惡魔救世主 (美版 970519)	魔域幽靈: 惡魔救世主 (美版 970519)	Capcom
vsavj	魔域幽靈: 惡魔救世主 (日版 970519)	魔域幽靈: 惡魔救世主 (日版 970519)	Capcom
vsava	魔域幽靈: 惡魔救世主 (亞洲版 970519)	魔域幽靈: 惡魔救世主 (亞洲版 970519)	Capcom
vsavh	魔域幽靈: 惡魔救世主 (西班牙版 970519)	魔域幽靈: 惡魔救世主 (西班牙版 970519)	Capcom
mshvsf	美國超人 Vs. 快打旋風 (歐洲版 970625)	美國超人 Vs. 快打旋風 (歐洲版 970625)	Capcom
mshvsfu	美國超人 Vs. 快打旋風 (美版 970827)	美國超人 Vs. 快打旋風 (美版 970827)	Capcom
mshvsfu1	美國超人 Vs. 快打旋風 (美版 970625)	美國超人 Vs. 快打旋風 (美版 970625)	Capcom
mshvsfj	美國超人 Vs. 快打旋風 (日版 970707)	美國超人 Vs. 快打旋風 (日版 970707)	Capcom
mshvsfj1	美國超人 Vs. 快打旋風 (日版 970702)	美國超人 Vs. 快打旋風 (日版 970702)	Capcom
mshvsfj2	美國超人 Vs. 快打旋風 (日版 970625)	美國超人 Vs. 快打旋風 (日版 970625)	Capcom
mshvsfh	美國超人 Vs. 快打旋風 (西班牙版 970625)	美國超人 Vs. 快打旋風 (西班牙版 970625)	Capcom
mshvsfa	美國超人 Vs. 快打旋風 (亞洲版 970625)	美國超人 Vs. 快打旋風 (亞洲版 970625)	Capcom
mshvsfa1	美國超人 Vs. 快打旋風 (亞洲版 970620)	美國超人 Vs. 快打旋風 (亞洲版 970620)	Capcom
mshvsfb	美國超人 Vs. 快打旋風 (巴西版 970827)	美國超人 Vs. 快打旋風 (巴西版 970827)	Capcom
mshvsfb1	美國超人 Vs. 快打旋風 (巴西版 970625)	美國超人 Vs. 快打旋風 (巴西版 970625)	Capcom
csclub	美國超人 Vs. 快打旋風 (歐洲版 970722)	美國超人 Vs. 快打旋風 (歐洲版 970722)	Capcom
csclubj	卡普空運動俱樂部 (日版 970722)	卡普空運動俱樂部 (日版 970722)	Capcom
cscluba	卡普空運動俱樂部 (亞洲版 970722)	卡普空運動俱樂部 (亞洲版 970722)	Capcom
csclubh	卡普空運動俱樂部 (西班牙版 970722)	卡普空運動俱樂部 (西班牙版 970722)	Capcom
sgemf	超級口袋快打 (美版 970904)	超級口袋快打 (美版 970904)	Capcom
pfghtj	超級口袋快打 (日版 970904)	超級口袋快打 (日版 970904)	Capcom
sgemfa	超級口袋快打 (亞洲版 970904)	超級口袋快打 (亞洲版 970904)	Capcom
sgemfh	超級口袋快打 (西班牙版 970904)	超級口袋快打 (西班牙版 970904)	Capcom
vhunt2r1	魔域幽靈 2: 惡魔的復仇 (日版 970913)	魔域幽靈 2: 惡魔的復仇 (日版 970913)	Capcom
vhunt2	魔域幽靈 2: 惡魔的復仇 (日版 970929)	魔域幽靈 2: 惡魔的復仇 (日版 970929)	Capcom
vsav2	魔域幽靈 2: 惡魔救世主 (日版 970913)	魔域幽靈 2: 惡魔救世主 (日版 970913)	Capcom
mvsc	美國超人 Vs. 卡普空 (美版 980123)	美國超人 Vs. 卡普空 (美版 980123)	Capcom
mvscj	美國超人 Vs. 卡普空 (日版 980123)	美國超人 Vs. 卡普空 (日版 980123)	Capcom
mvscjr1	美國超人 Vs. 卡普空 (日版 980112)	美國超人 Vs. 卡普空 (日版 980112)	Capcom
mvsca	美國超人 Vs. 卡普空 (亞洲版 980123)	美國超人 Vs. 卡普空 (亞洲版 980123)	Capcom
mvscar1	美國超人 Vs. 卡普空 (亞洲版 980112)	美國超人 Vs. 卡普空 (亞洲版 980112)	Capcom
mvsch	美國超人 Vs. 卡普空 (西班牙版 980123)	美國超人 Vs. 卡普空 (西班牙版 980123)	Capcom
mvscb	美國超人 Vs. 卡普空 (巴西版 980123)	美國超人 Vs. 卡普空 (巴西版 980123)	Capcom
sfa3	少年快打 3 (美版 980904)	少年快打 3 (美版 980904)	Capcom
sfa3r1	少年快打 3 (美版 980629)	少年快打 3 (美版 980629)	Capcom
sfa3b	少年快打 3 (巴西版 980629)	少年快打 3 (巴西版 980629)	Capcom
sfz3j	少年快打 3 (日版 980904)	少年快打 3 (日版 980904)	Capcom
sfz3jr1	少年快打 3 (日版 980727)	少年快打 3 (日版 980727)	Capcom
sfz3jr2	少年快打 3 (日版 980629)	少年快打 3 (日版 980629)	Capcom
sfz3a	少年快打 3 (亞洲版 980904)	少年快打 3 (亞洲版 980904)	Capcom
sfz3ar1	少年快打 3 (亞洲版 980701)	少年快打 3 (亞洲版 980701)	Capcom
gigawing	激鋼之翼 (美版 990222)	激鋼之翼 (美版 990222)	Capcom, supported by Takumi
gwingj	激鋼之翼 (日版 990223)	激鋼之翼 (日版 990223)	Capcom, supported by Takumi
gwinga	激鋼之翼 (亞洲版 990222)	激鋼之翼 (亞洲版 990222)	Capcom, supported by Takumi
dimahoo	偉大魔法大作戰 (美版 000121)	偉大魔法大作戰 (美版 000121)	Eighting/Raizing, distributed by Capcom
gmahou	偉大魔法大作戰 (日版 000121)	偉大魔法大作戰 (日版 000121)	Eighting/Raizing, distributed by Capcom
mmatrix	火星任務: 超固體射擊 (美版 000412)	火星任務: 超固體射擊 (美版 000412)	Capcom, supported by Takumi
mmatrixj	火星任務: 超固體射擊 (日版 000412)	火星任務: 超固體射擊 (日版 000412)	Capcom, supported by Takumi
1944	1944: 特技飛行大師 (美版 000620)	1944: 特技飛行大師 (美版 000620)	Capcom, supported by Eighting/Raizing
1944j	1944: 特技飛行大師 (日版 000620)	1944: 特技飛行大師 (日版 000620)	Capcom, supported by Eighting/Raizing
mpangj	強力! 魔法氣泡 (日版 001011)	強力! 魔法氣泡 (日版 001011)	Mitchell, distributed by Capcom
progear	能源之嵐 (美版 010117)	能源之嵐 (美版 010117)	Capcom, supported by Cave
progearj	能源之嵐 (日版 010117)	能源之嵐 (日版 010117)	Capcom, supported by Cave
progeara	能源之嵐 (亞洲版 010117)	能源之嵐 (亞洲版 010117)	Capcom, supported by Cave
pzloop2j	渦輪泡泡 2 (日版 010205)	渦輪泡泡 2 (日版 010205)	Mitchell, distributed by Capcom
warzard	戰亂之國	戰亂之國	Capcom
sfiii	快打旋風 III - 新世代	快打旋風 III - 新世代	Capcom
jojo	JoJo 的奇妙冒險	JoJo 的奇妙冒險	Capcom
jojoba	JoJo 的奇妙冒險 未來遺產	JoJo 的奇妙冒險 未來遺產	Capcom
jojobaa	JoJo 的奇妙冒險 未來遺產 (alt)	JoJo 的奇妙冒險 未來遺產 (alt)	Capcom
sfiii2	快打旋風 III 第二次衝擊 - 巨型攻擊	快打旋風 III 第二次衝擊 - 巨型攻擊	Capcom
sfiii3	快打旋風 III 第三次攻擊 - 未來戰鬥	快打旋風 III 第三次攻擊 - 未來戰鬥	Capcom
ts2	鬥神傳 2 (美版 951124)	鬥神傳 2 (美版 951124)	Capcom/Takara
ts2j	鬥神傳 2 (日版 951124)	鬥神傳 2 (日版 951124)	Capcom/Takara
sfex	快打旋風 EX (美版 961219)	快打旋風 EX (美版 961219)	Capcom/Arika
sfexa	快打旋風 EX (亞洲版 961219)	快打旋風 EX (亞洲版 961219)	Capcom/Arika
sfexj	快打旋風 EX (日版 961130)	快打旋風 EX (日版 961130)	Capcom/Arika
sfexp	快打旋風 EX Plus (美版 970407)	快打旋風 EX Plus (美版 970407)	Capcom/Arika
sfexpu1	快打旋風 EX Plus (美版 970311)	快打旋風 EX Plus (美版 970311)	Capcom/Arika
sfexpj	快打旋風 EX Plus (日版 970311)	快打旋風 EX Plus (日版 970311)	Capcom/Arika
sfex2	快打旋風 EX 2 (美版 980526)	快打旋風 EX 2 (美版 980526)	Capcom/Arika
sfex2j	快打旋風 EX 2 (日版 980312)	快打旋風 EX 2 (日版 980312)	Capcom/Arika
tgmj	俄羅斯方塊大師 (日版 980710)	俄羅斯方塊大師 (日版 980710)	Capcom/Arika
sfex2p	快打旋風 EX 2 Plus (美版 990611)	快打旋風 EX 2 Plus (美版 990611)	Capcom/Arika
sfex2pa	快打旋風 EX 2 Plus (亞洲版 990611)	快打旋風 EX 2 Plus (亞洲版 990611)	Capcom/Arika
sfex2pj	快打旋風 EX 2 Plus (日版 990611)	快打旋風 EX 2 Plus (日版 990611)	Capcom/Arika
strider2	出擊飛龍 2 (亞洲版 991213)	出擊飛龍 2 (亞洲版 991213)	Capcom
shiryu2	出擊飛龍 Hiryu 2 (日版 991213)	出擊飛龍 Hiryu 2 (日版 991213)	Capcom
shngmtkb	上海: 真的武勇	上海: 真的武勇	Sunsoft / Activision
tekken	鐵拳 (TE4/VER.C)	鐵拳 (TE4/VER.C)	Namco
tekkena	鐵拳 (TE2/VER.C)	鐵拳 (TE2/VER.C)	Namco
tekkenb	鐵拳 (TE2/VER.B)	鐵拳 (TE2/VER.B)	Namco
tekkenc	鐵拳 (TE1/VER.B)	鐵拳 (TE1/VER.B)	Namco
tekken2	鐵拳 2 Ver.B (TES3/VER.B)	鐵拳 2 Ver.B (TES3/VER.B)	Namco
tekken2a	鐵拳 2 Ver.B (TES2/VER.B)	鐵拳 2 Ver.B (TES2/VER.B)	Namco
tekken2b	鐵拳 2 (TES2/VER.A)	鐵拳 2 (TES2/VER.A)	Namco
tekken3	鐵拳 3 (TET1/VER.E1)	鐵拳 3 (TET1/VER.E1)	Namco
tekken3a	鐵拳 3 (TET2/VER.A)	鐵拳 3 (TET2/VER.A)	Namco
tekkentt	鐵拳錦標賽 (TEG3/VER.B)	鐵拳錦標賽 (TEG3/VER.B)	Namco
pbball96	實況野球 '96 (GV017 日版 1.03)	實況野球 '96 (GV017 日版 1.03)	Konami
mgakuen	麻雀學園 - 卒業編	麻雀學園 - 卒業編	Yuga
7toitsu	麻雀學園 / 七對子	麻雀學園 / 七對子	Yuga
mgakuen2	麻雀學園 2 - 學園長的復仇	麻雀學園 2 - 學園長的復仇	Face
pkladies	同花順	同花順	Mitchell
pkladiel	同花順 (Leprechaun ver. 510)	同花順 (Leprechaun ver. 510)	Leprechaun
pkladila	同花順 (Leprechaun ver. 401)	同花順 (Leprechaun ver. 401)	Leprechaun
pang	魔法氣泡 (世界版)	魔法氣泡 (世界版)	Mitchell
pangb	魔法氣泡 (bootleg)	魔法氣泡 (bootleg)	bootleg
bbros	魔法氣泡 (美版)	魔法氣泡 (美版)	Capcom
pompingw	魔法氣泡 (日版)	魔法氣泡 (日版)	Mitchell
cbasebal	卡普空棒球 (日版)	卡普空棒球 (日版)	Capcom
cworld	卡普空問答 (日版)	卡普空問答 (日版)	Capcom
hatena	冒險問答 2 Hatena 大冒險 (日版 900228)	冒險問答 2 Hatena 大冒險 (日版 900228)	Capcom
spang	超級氣泡 (世界版 900914)	超級氣泡 (世界版 900914)	Mitchell
spangj	超級氣泡 (日版 901023)	超級氣泡 (日版 901023)	Mitchell
sbbros	超級氣泡 (美版 901001)	超級氣泡 (美版 901001)	Mitchell + Capcom
marukin	超級麻將 (日版 901017)	超級麻將 (日版 901017)	Yuga
qtono1	問答 殿樣之野望 (日版)	問答 殿樣之野望 (日版)	Capcom
qsangoku	問答 三國誌 - 智略的霸者 (日版)	問答 三國誌 - 智略的霸者 (日版)	Capcom
block	敲磚塊 (世界版 911106 搖桿)	敲磚塊 (世界版 911106 搖桿)	Capcom
blocka	敲磚塊 (世界版 910910)	敲磚塊 (世界版 910910)	Capcom
blockj	敲磚塊 (日版 910910)	敲磚塊 (日版 910910)	Capcom
blockbl	敲磚塊 (bootleg)	敲磚塊 (bootleg)	bootleg
capbowl	卡普空保齡球 (set 1)	卡普空保齡球 (set 1)	Incredible Technologies
capbowl2	卡普空保齡球 (set 2)	卡普空保齡球 (set 2)	Incredible Technologies
capbowl3	卡普空保齡球 (set 3)	卡普空保齡球 (set 3)	Incredible Technologies
capbowl4	卡普空保齡球 (set 4)	卡普空保齡球 (set 4)	Incredible Technologies
clbowl	卡普空保齡球 / Coors Light Bowling	卡普空保齡球 / Coors Light Bowling	Incredible Technologies
pairs	美女撲克 (V1.2, 09/30/94)	美女撲克 (V1.2, 09/30/94)	Strata/Incredible Technologies
pairsa	美女撲克 (09/07/94)	美女撲克 (09/07/94)	Strata/Incredible Technologies
sftm	快打旋風: 電影版 (v1.12)	快打旋風: 電影版 (v1.12)	Capcom/Incredible Technologies
sftm110	快打旋風: 電影版 (v1.10)	快打旋風: 電影版 (v1.10)	Capcom/Incredible Technologies
sftm111	快打旋風: 電影版 (v1.11)	快打旋風: 電影版 (v1.11)	Capcom/Incredible Technologies
sftmj	快打旋風: 電影版 (v1.12N, 日版)	快打旋風: 電影版 (v1.12N, 日版)	Capcom/Incredible Technologies
wseries	世界職業棒球大賽	世界職業棒球大賽	Cinematronics
dangerz	危險地帶	危險地帶	Cinematronics
basebal2	棒球季節 II	棒球季節 II	Cinematronics
aafb	美式足球 (rev E)	美式足球 (rev E)	Leland Corp.
aafbd2p	美式足球 (rev D, 2 Players)	美式足球 (rev D, 2 Players)	Leland Corp.
aafbc	美式足球 (rev C)	美式足球 (rev C)	Leland Corp.
aafbb	美式足球 (rev B)	美式足球 (rev B)	Leland Corp.
wsf	世界足球最終戰	世界足球最終戰	Leland Corp.
brutforc	極之暴力	極之暴力	Leland Corp.
mineswpr	掃雷艇	掃雷艇	Amutech
sspaceat	太空攻擊 (直立型 set 1)	太空攻擊 (直立型 set 1)	Sega
sspacat2	太空攻擊 (直立型 set 2)	太空攻擊 (直立型 set 2)	Sega
sspacat3	太空攻擊 (直立型 set 3)	太空攻擊 (直立型 set 3)	Sega
sspacatc	太空攻擊 (檯面型)	太空攻擊 (檯面型)	Sega
samurai	武士	武士	Sega
heiankyo	平安京異形	平安京異形	Denki Onkyo
bullfgt	鬥牛 / Bullfight	鬥牛 / Bullfight	Coreland / Sega
thetogyu	鬥牛 (日版)	鬥牛 (日版)	Coreland / Sega
seganinj	忍者王子 / Sega 忍者	忍者王子 / Sega 忍者	Sega
seganinu	忍者王子 / Sega 忍者 (not encrypted)	忍者王子 / Sega 忍者 (not encrypted)	Sega
ninja	忍者王子	忍者王子	Sega
nprinces	忍者王子 (64k Ver. bootleg?)	忍者王子 (64k Ver. bootleg?)	bootleg?
nprincso	忍者王子 (128k Ver.)	忍者王子 (128k Ver.)	Sega
nprincsu	忍者王子 (64k Ver. not encrypted)	忍者王子 (64k Ver. not encrypted)	Sega
nprincsb	忍者王子 (128k Ver. bootleg?)	忍者王子 (128k Ver. bootleg?)	bootleg?
myhero	我的英雄 (美版)	我的英雄 (美版)	Sega
sscandal	我的英雄 / Seishun Scandal (日版)	我的英雄 / Seishun Scandal (日版)	Coreland / Sega
myherok	我的英雄 (韓國版)	我的英雄 (韓國版)	Coreland / Sega
4dwarrio	4-D 戰士	4-D 戰士	Coreland / Sega
wboy	神奇男孩 (set 1, new encryption)	神奇男孩 (set 1, new encryption)	Sega (Escape license)
wboyo	神奇男孩 (set 1, old encryption)	神奇男孩 (set 1, old encryption)	Sega (Escape license)
wboy2	神奇男孩 (set 2)	神奇男孩 (set 2)	Sega (Escape license)
wboy2u	神奇男孩 (set 2 not encrypted)	神奇男孩 (set 2 not encrypted)	Sega (Escape license)
wboy3	神奇男孩 (set 3)	神奇男孩 (set 3)	Sega (Escape license)
wboyu	神奇男孩 (not encrypted)	神奇男孩 (not encrypted)	Sega (Escape license)
wbdeluxe	神奇男孩 Deluxe	神奇男孩 Deluxe	Sega (Escape license)
tokisens	時間戰士	時間戰士	Sega
wbml	神奇男孩在魔界 (日版 New Ver.)	神奇男孩在魔界 (日版 New Ver.)	Sega / Westone
wbmljo	神奇男孩在魔界 (日版 Old Ver.)	神奇男孩在魔界 (日版 Old Ver.)	Sega / Westone
wbmljb	神奇男孩在魔界 (日版 not encrypted)	神奇男孩在魔界 (日版 not encrypted)	bootleg
wbmlb	神奇男孩在魔界 	神奇男孩在魔界 	bootleg
transfrm	變形金剛 / Transformer	變形金剛 / Transformer	Sega
astrofl	變形金剛 (日版)	變形金剛 (日版)	Sega
tetrisse	俄羅斯方塊 (日版, System E)	俄羅斯方塊 (日版, System E)	Sega
bodyslam	Dump 松本 / Body Slam (8751 317-unknown)	Dump 松本 / Body Slam (8751 317-unknown)	Sega
dumpmtmt	Dump 松本 (日版, 8751 317-unknown)	Dump 松本 (日版, 8751 317-unknown)	Sega
mjleague	棒球聯盟	棒球聯盟	Sega
fantzone	神奇地帶 (set 2, unprotected)	神奇地帶 (set 2, unprotected)	Sega
fantzon1	神奇地帶 (set 1, unprotected)	神奇地帶 (set 1, unprotected)	Sega
sdi	SDI - 戰略防衛構想 (歐洲版, System 16A, FD1089B 317-0027)	SDI - 戰略防衛構想 (歐洲版, System 16A, FD1089B 317-0027)	Sega
shinobi	忍 (set 5, System 16A, unprotected)	忍 (set 5, System 16A, unprotected)	Sega
shinobi1	忍 (set 1, System 16A, FD1094 317-0050)	忍 (set 1, System 16A, FD1094 317-0050)	Sega
tetris	俄羅斯方塊 (set 4, 日版, System 16A, FD1094 317-0093)	俄羅斯方塊 (set 4, 日版, System 16A, FD1094 317-0093)	Sega
tetris3	俄羅斯方塊 (set 3, 日版, System 16A, FD1094 317-0093a)	俄羅斯方塊 (set 3, 日版, System 16A, FD1094 317-0093a)	Sega
altbeast	獸王記 (set 7, 8751 317-0078)	獸王記 (set 7, 8751 317-0078)	Sega
altbeasj	獸王記 (set 6, 日版, 8751 317-0077)	獸王記 (set 6, 日版, 8751 317-0077)	Sega
altbeas5	獸王記 (set 5, 8751 317-0076)	獸王記 (set 5, 8751 317-0076)	Sega
altbeas4	獸王記 (set 4, MC-8123B 317-0066)	獸王記 (set 4, MC-8123B 317-0066)	Sega
altbeaj3	獸王記 (set 3, 日版, FD1094 317-0068)	獸王記 (set 3, 日版, FD1094 317-0068)	Sega
altbeas2	獸王記 (set 2, MC-8123B 317-0066)	獸王記 (set 2, MC-8123B 317-0066)	Sega
altbeaj1	獸王記 (set 1, 日版, FD1094 317-0065)	獸王記 (set 1, 日版, FD1094 317-0065)	Sega
goldnaxe	戰斧 (set 6, 美版, 8751 317-123A)	戰斧 (set 6, 美版, 8751 317-123A)	Sega
goldnaxu	戰斧 (set 5, 美版, FD1094 317-0122)	戰斧 (set 5, 美版, FD1094 317-0122)	Sega
goldnaxj	戰斧 (set 4, 日版, FD1094 317-0121)	戰斧 (set 4, 日版, FD1094 317-0121)	Sega
goldnax3	戰斧 (set 3, 世界版, FD1094 317-0120)	戰斧 (set 3, 世界版, FD1094 317-0120)	Sega
goldnax2	戰斧 (set 2, 美版, 8751 317-0112)	戰斧 (set 2, 美版, 8751 317-0112)	Sega
goldnax1	戰斧 (set 1, 世界版, FD1094 317-0110)	戰斧 (set 1, 世界版, FD1094 317-0110)	Sega
hwchamp	重量拳擊	重量拳擊	Sega
riotcity	暴亂之城 (日版)	暴亂之城 (日版)	Sega / Westone
tetris2	俄羅斯方塊 (set 2, 日版, System 16B, FD1094 317-0092)	俄羅斯方塊 (set 2, 日版, System 16B, FD1094 317-0092)	Sega
tetris1	俄羅斯方塊 (set 1, 日版, System 16B, FD1094 317-0091)	俄羅斯方塊 (set 1, 日版, System 16B, FD1094 317-0091)	Sega
toryumon	登龍門	登龍門	Sega
wb3	神奇男孩 III - 魔窟 (set 5, 世界版, System 16B, 8751 317-0098)	神奇男孩 III - 魔窟 (set 5, 世界版, System 16B, 8751 317-0098)	Sega / Westone
wb34	神奇男孩 III - 魔窟 (set 4, 日版, System 16B, FD1094 317-0087)	神奇男孩 III - 魔窟 (set 4, 日版, System 16B, FD1094 317-0087)	Sega / Westone
wb33	神奇男孩 III - 魔窟 (set 3, 世界版, System 16B, FD1094 317-0089)	神奇男孩 III - 魔窟 (set 3, 世界版, System 16B, FD1094 317-0089)	Sega / Westone
wb32	神奇男孩 III - 魔窟 (set 2, 日版, System 16B, FD1094 317-0085)	神奇男孩 III - 魔窟 (set 2, 日版, System 16B, FD1094 317-0085)	Sega / Westone
dduxbl	怪鴨冒險記 (bootleg)	怪鴨冒險記 (bootleg)	bootleg
goldnabl	戰斧 (bootleg)	戰斧 (bootleg)	bootleg
shinobl	忍 (bootleg)	忍 (bootleg)	bootleg
tetrisbl	俄羅斯方塊 (bootleg)	俄羅斯方塊 (bootleg)	bootleg
astorm	異形風暴 (set 4, 2 Players, FD1094 317-?)	異形風暴 (set 4, 2 Players, FD1094 317-?)	Sega
astorm3	異形風暴 (set 3, 世界版, 3 Players, FD1094 317-0148)	異形風暴 (set 3, 世界版, 3 Players, FD1094 317-0148)	Sega
astormu	異形風暴 (set 2, 美版, 3 Players, FD1094 317-0147)	異形風暴 (set 2, 美版, 3 Players, FD1094 317-0147)	Sega
astormj	異形風暴 (set 1, 日版, 2 Players, FD1094 317-0146)	異形風暴 (set 1, 日版, 2 Players, FD1094 317-0146)	Sega
shdancer	影武者 (set 3, 美版)	影武者 (set 3, 美版)	Sega
shdancej	影武者 (set 2, 日版)	影武者 (set 2, 日版)	Sega
shdance1	影武者 (set 1)	影武者 (set 1)	Sega
astormbl	異形風暴 (bootleg)	異形風暴 (bootleg)	bootleg
shdancbl	影武者 (bootleg)	影武者 (bootleg)	bootleg
aburner	衝破火網 (日版)	衝破火網 (日版)	Sega
aburner2	衝破火網 II	衝破火網 II	Sega
sonic	音速小子 (日版, rev. C)	音速小子 (日版, rev. C)	Sega
sonicp	音速小子 (日版, prototype)	音速小子 (日版, prototype)	Sega
ga2	戰斧 2 / Golden Axe - The Revenge of Death Adder (世界版)	戰斧 2 / Golden Axe - The Revenge of Death Adder (世界版)	Sega
ga2u	戰斧 2 / Golden Axe - The Revenge of Death Adder (美版)	戰斧 2 / Golden Axe - The Revenge of Death Adder (美版)	Sega
ga2j	戰斧 2 / Golden Axe - The Revenge of Death Adder (日版)	戰斧 2 / Golden Axe - The Revenge of Death Adder (日版)	Sega
spidman	蜘蛛人 (世界版)	蜘蛛人 (世界版)	Sega
spidmanu	蜘蛛人 (美版)	蜘蛛人 (美版)	Sega
hanagumi	櫻花大戰 - 寶石方塊 (J 971007 V1.010)	櫻花大戰 - 寶石方塊 (J 971007 V1.010)	Sega
shanhigw	上海 - 萬里長城 (JUE 950623 V1.005)	上海 - 萬里長城 (JUE 950623 V1.005)	Sunsoft / Activision
shienryu	紫炎龍 (JUET 961226 V1.000)	紫炎龍 (JUET 961226 V1.000)	Warashi
suikoenb	水滸演武 (J 950314 V2.001)	水滸演武 (J 950314 V2.001)	Data East
karianx	魔法寶石 (Rev. 1.0)	魔法寶石 (Rev. 1.0)	Deniam
tfrceac	雷霆力量 AC	雷霆力量 AC	Sega / Technosoft
tfrceacj	雷霆力量 AC (日版)	雷霆力量 AC (日版)	Sega / Technosoft
tfrceacb	雷霆力量 AC (bootleg)	雷霆力量 AC (bootleg)	bootleg
puckpkmn	小精靈與皮卡丘	小精靈與皮卡丘	Genie
mt_beast	獸王記 (Mega-Tech)	獸王記 (Mega-Tech)	Sega
mt_gaxe	戰斧 (Mega-Tech)	戰斧 (Mega-Tech)	Sega
mt_gaxe2	戰斧 II (Mega-Tech)	戰斧 II (Mega-Tech)	Sega
mp_gaxe2	戰斧 II (Mega Play)	戰斧 II (Mega Play)	Sega
zoar	X 任務 / 避難所	X 任務 / 避難所	Data East USA
wtennis	世界網球	世界網球	bootleg
astrof	宇宙飛行士 (set 1)	宇宙飛行士 (set 1)	Data East
astrof2	宇宙飛行士 (set 2)	宇宙飛行士 (set 2)	Data East
astrof3	宇宙飛行士 (set 3)	宇宙飛行士 (set 3)	Data East
kchamp	對戰空手道 (美版)	對戰空手道 (美版)	Data East USA
karatedo	對戰空手道 (日版)	對戰空手道 (日版)	Data East Corporation
kchampvs	對戰空手道 (美版 VS version)	對戰空手道 (美版 VS version)	Data East USA
karatevs	對戰空手道 (日版 VS version)	對戰空手道 (日版 VS version)	Data East Corporation
zerotrgt	擊隊王 (世界版)	擊隊王 (世界版)	Data East Corporation
gekitsui	擊隊王 (日版)	擊隊王 (日版)	Data East Corporation
firetrap	烈焰陷阱 (美版)	烈焰陷阱 (美版)	Data East USA
firetpbl	烈焰陷阱 (日版 bootleg)	烈焰陷阱 (日版 bootleg)	bootleg
brkthru	強行突破 (美版)	強行突破 (美版)	Data East USA
brkthruj	強行突破 (日版)	強行突破 (日版)	Data East Corporation
darwin	黑暗之風 4078 (日版)	黑暗之風 4078 (日版)	Data East Corporation
exprraid	火車大盜 / 西部急行列車 (美版)	火車大盜 / 西部急行列車 (美版)	Data East USA
exprrada	火車大盜 / 西部急行列車 (美版 set 2)	火車大盜 / 西部急行列車 (美版 set 2)	Data East USA
wexpress	火車大盜 / 西部急行列車 (世界版?)	火車大盜 / 西部急行列車 (世界版?)	Data East Corporation
wexpresb	火車大盜 / 西部急行列車 (bootleg set 1)	火車大盜 / 西部急行列車 (bootleg set 1)	bootleg
wexpresc	火車大盜 / 西部急行列車 (bootleg set 2)	火車大盜 / 西部急行列車 (bootleg set 2)	bootleg
pcktgal	花式撞球 (日版)	花式撞球 (日版)	Data East Corporation
pcktgalb	花式撞球 (bootleg)	花式撞球 (bootleg)	bootleg
pcktgal2	花式撞球 2 (世界版?)	花式撞球 2 (世界版?)	Data East Corporation
spool3	花式撞球 / Super Pool III (世界版?)	花式撞球 / Super Pool III (世界版?)	Data East Corporation
spool3i	花式撞球 / Super Pool III (I-Vics)	花式撞球 / Super Pool III (I-Vics)	Data East Corporation (I-Vics license)
battlera	惡人戰鬥部隊 嗜血野狼 (世界版)	惡人戰鬥部隊 嗜血野狼 (世界版)	Data East Corporation
bldwolf	惡人戰鬥部隊 嗜血野狼 (美版)	惡人戰鬥部隊 嗜血野狼 (美版)	Data East USA
lastmisn	最終任務 (美版 revision 6)	最終任務 (美版 revision 6)	Data East USA
lastmsno	最終任務 (美版 revision 5)	最終任務 (美版 revision 5)	Data East USA
lastmsnj	最終任務 (日版)	最終任務 (日版)	Data East Corporation
ghostb	迷宮獵人 G (美版 2 Players)	迷宮獵人 G (美版 2 Players)	Data East USA
ghostb3	迷宮獵人 G (美版 3 Players)	迷宮獵人 G (美版 3 Players)	Data East USA
meikyuh	迷宮獵人 G (日版)	迷宮獵人 G (日版)	Data East Corporation
srdarwin	黑暗之風 2 (世界版)	黑暗之風 2 (世界版)	Data East Corporation
srdarwnj	黑暗之風 2 (日版)	黑暗之風 2 (日版)	Data East Corporation
gondo	魔境戰士 / 絕對合體 (美版)	魔境戰士 / 絕對合體 (美版)	Data East USA
makyosen	魔境戰士 / 絕對合體 (日版)	魔境戰士 / 絕對合體 (日版)	Data East Corporation
garyoret	臥龍列傳 (日版)	臥龍列傳 (日版)	Data East Corporation
cobracom	眼睛蛇指令 (世界版 revision 5)	眼睛蛇指令 (世界版 revision 5)	Data East Corporation
cobracmj	眼睛蛇指令 (日版)	眼睛蛇指令 (日版)	Data East Corporation
karnov	格鬥列傳 (美版)	格鬥列傳 (美版)	Data East USA
karnovj	格鬥列傳 (日版)	格鬥列傳 (日版)	Data East Corporation
wndrplnt	不思議的星球 (日版)	不思議的星球 (日版)	Data East Corporation
chelnov	原子超人 (世界版)	原子超人 (世界版)	Data East Corporation
chelnovu	原子超人 (美版)	原子超人 (美版)	Data East USA
chelnovj	原子超人 (日版)	原子超人 (日版)	Data East Corporation
baddudes	龍行忍者 (美版)	龍行忍者 (美版)	Data East USA
drgninja	龍之忍者 (日版)	龍之忍者 (日版)	Data East Corporation
robocop	機械戰警 (世界版 revision 4)	機械戰警 (世界版 revision 4)	Data East Corporation
robocopw	機器戰警 (世界版 revision 3)	機器戰警 (世界版 revision 3)	Data East Corporation
robocopj	機器戰警 (日版)	機器戰警 (日版)	Data East Corporation
robocopu	機器戰警 (美版 revision 1)	機器戰警 (美版 revision 1)	Data East USA
robocpu0	機器戰警 (美版 revision 0)	機器戰警 (美版 revision 0)	Data East USA
robocopb	機器戰警 (世界版 bootleg)	機器戰警 (世界版 bootleg)	bootleg
hippodrm	競技場 (美版)	競技場 (美版)	Data East USA
ffantasy	激鬥幻想 (日版 revision 2)	激鬥幻想 (日版 revision 2)	Data East Corporation
ffantasa	激鬥幻想 (日版)	激鬥幻想 (日版)	Data East Corporation
madmotor	瘋狂摩托車	瘋狂摩托車	Mitchell
vaportra	空牙 - 行動代號 飛機雲 (世界版 revision 1)	空牙 - 行動代號 飛機雲 (世界版 revision 1)	Data East Corporation
vaportru	空牙 - 行動代號 飛機雲 (美版)	空牙 - 行動代號 飛機雲 (美版)	Data East USA
kuhga	空牙 - 行動代號 飛機雲 (日版 revision 3)	空牙 - 行動代號 飛機雲 (日版 revision 3)	Data East Corporation
cbuster	暴力剋星 (世界版 FX version)	暴力剋星 (世界版 FX version)	Data East Corporation
cbusterw	暴力剋星 (世界版 FU version)	暴力剋星 (世界版 FU version)	Data East Corporation
cbusterj	暴力剋星 (日版)	暴力剋星 (日版)	Data East Corporation
twocrude	暴力剋星 (美版)	暴力剋星 (美版)	Data East USA
darkseal	暗黑封印 / 毀滅之門 (世界版 revision 3)	暗黑封印 / 毀滅之門 (世界版 revision 3)	Data East Corporation
darksea1	暗黑封印 / 毀滅之門 (世界版 revision 1)	暗黑封印 / 毀滅之門 (世界版 revision 1)	Data East Corporation
darkseaj	暗黑封印 / 毀滅之門 (日版)	暗黑封印 / 毀滅之門 (日版)	Data East Corporation
gatedoom	暗黑封印 / 毀滅之門 (美版 revision 4)	暗黑封印 / 毀滅之門 (美版 revision 4)	Data East Corporation
gatedom1	暗黑封印 / 毀滅之門 (美版 revision 1)	暗黑封印 / 毀滅之門 (美版 revision 1)	Data East Corporation
cninja	戰鬥原始人 (世界版 revision 3)	戰鬥原始人 (世界版 revision 3)	Data East Corporation
cninja0	戰鬥原始人 (世界版 revision 0)	戰鬥原始人 (世界版 revision 0)	Data East Corporation
cninjau	戰鬥原始人 (美版)	戰鬥原始人 (美版)	Data East Corporation
joemac	戰鬥原始人 (日版)	戰鬥原始人 (日版)	Data East Corporation
stoneage	戰鬥原始人	戰鬥原始人	bootleg
robocop2	機器戰警 2 (歐洲版/亞洲版 v0.10)	機器戰警 2 (歐洲版/亞洲版 v0.10)	Data East Corporation
robocp2u	機器戰警 2 (美版 v0.05)	機器戰警 2 (美版 v0.05)	Data East Corporation
robocp2j	機器戰警 2 (日版 v0.11)	機器戰警 2 (日版 v0.11)	Data East Corporation
chinatwn	唐人街 (日版)	唐人街 (日版)	Data East Corporation
captaven	美國隊長 (亞洲版 Rev 1.9)	美國隊長 (亞洲版 Rev 1.9)	Data East Corporation
captavna	美國隊長 (亞洲版 Rev 1.0)	美國隊長 (亞洲版 Rev 1.0)	Data East Corporation
captavne	美國隊長 (英國版 Rev 1.4)	美國隊長 (英國版 Rev 1.4)	Data East Corporation
captavnu	美國隊長 (美版 Rev 1.9)	美國隊長 (美版 Rev 1.9)	Data East Corporation
captavuu	美國隊長 (美版 Rev 1.6)	美國隊長 (美版 Rev 1.6)	Data East Corporation
captavnj	美國隊長 (日版 Rev 0.2)	美國隊長 (日版 Rev 0.2)	Data East Corporation
tumblep	捉鬼大師 (世界版)	捉鬼大師 (世界版)	Data East Corporation
tumblepj	捉鬼大師 (日版)	捉鬼大師 (日版)	Data East Corporation
tumblepb	捉鬼大師 (bootleg set 1)	捉鬼大師 (bootleg set 1)	bootleg
tumblep2	捉鬼大師 (bootleg set 2)	捉鬼大師 (bootleg set 2)	bootleg
sotsugyo	卒業證書	卒業證書	Mitchell (Atlus license)
sshangha	超級上海 (日版)	超級上海 (日版)	Hot-B.
sshanghb	超級上海 (世界版, bootleg)	超級上海 (世界版, bootleg)	bootleg
starforc	星際武力	星際武力	Tehkan
starfore	星際武力 (encrypted)	星際武力 (encrypted)	Tehkan
megaforc	星際武力	星際武力	Tehkan (Video Ware license)
solomon	所羅門之鑰 (日版)	所羅門之鑰 (日版)	Tecmo
rygar	未來戰士 (美版 set 1)	未來戰士 (美版 set 1)	Tecmo
rygar2	未來戰士 (美版 set 2)	未來戰士 (美版 set 2)	Tecmo
rygarj	未來戰士 (日版)	未來戰士 (日版)	Tecmo
gemini	捉蟲敢死隊	捉蟲敢死隊	Tecmo
silkworm	聯合大作戰 (set 1)	聯合大作戰 (set 1)	Tecmo
silkwrm2	聯合大作戰 (set 2)	聯合大作戰 (set 2)	Tecmo
shadoww	忍者龍劍傳 (世界版 set 1)	忍者龍劍傳 (世界版 set 1)	Tecmo
shadowwa	忍者龍劍傳 (世界版 set 2)	忍者龍劍傳 (世界版 set 2)	Tecmo
gaiden	忍者龍劍傳 (美版)	忍者龍劍傳 (美版)	Tecmo
ryukendn	忍者龍劍傳 (日版)	忍者龍劍傳 (日版)	Tecmo
stratof	雪牙 (美版)	雪牙 (美版)	Tecmo
raiga	雪牙 (日版)	雪牙 (日版)	Tecmo
wc90	世界盃 '90 (set 1)	世界盃 '90 (set 1)	Tecmo
wc90a	世界盃 '90 (set 2)	世界盃 '90 (set 2)	Tecmo
wc90t	世界盃 '90 (軌跡球)	世界盃 '90 (軌跡球)	Tecmo
wc90b	世界盃 '90 / 歐洲聯盟	世界盃 '90 / 歐洲聯盟	bootleg
fstarfrc	最終星際武力 (美版)	最終星際武力 (美版)	Tecmo
psurge	電路小精靈	電路小精靈	<unknown>
pandoras	潘朵拉之殿	潘朵拉之殿	Konami/Interlogic
mikie	新入社員 Tooru 君 / Mikie	新入社員 Tooru 君 / Mikie	Konami
mikiej	新入社員 Tooru 君	新入社員 Tooru 君	Konami
mikiehs	新入社員 Tooru 君 / Mikie (High School Graffiti)	新入社員 Tooru 君 / Mikie (High School Graffiti)	Konami
kicker	少林之道 / Kicker	少林之道 / Kicker	Konami
shaolins	少林之道	少林之道	Konami
pingpong	乒乓球	乒乓球	Konami
gberet	綠色兵團	綠色兵團	Konami
rushatck	綠色兵團 / Rush'n Attack (美版)	綠色兵團 / Rush'n Attack (美版)	Konami
gberetb	綠色兵團 (bootleg)	綠色兵團 (bootleg)	bootleg
mrgoemon	Mr. 五右衛門 (日版)	Mr. 五右衛門 (日版)	Konami
ironhors	火車大盜	火車大盜	Konami
dairesya	火車大盜 (日版)	火車大盜 (日版)	[Konami] (Kawakusu license)
farwest	火車大盜 / 遙遠西部	火車大盜 / 遙遠西部	bootleg?
jackal	赤色要塞 / 特殊部隊 豺 (世界版)	赤色要塞 / 特殊部隊 豺 (世界版)	Konami
topgunr	赤色要塞 / 特殊部隊 豺 (美版)	赤色要塞 / 特殊部隊 豺 (美版)	Konami
jackalj	赤色要塞 / 特殊部隊 豺 (日版)	赤色要塞 / 特殊部隊 豺 (日版)	Konami
topgunbl	赤色要塞 / 特殊部隊 豺 (bootleg)	赤色要塞 / 特殊部隊 豺 (bootleg)	bootleg
contra	魂斗羅 (美版)	魂斗羅 (美版)	Konami
contrab	魂斗羅 (美版 bootleg)	魂斗羅 (美版 bootleg)	bootleg
contraj	魂斗羅 (日版)	魂斗羅 (日版)	Konami
contrajb	魂斗羅 (日版 bootleg)	魂斗羅 (日版 bootleg)	bootleg
gryzor	魂斗羅 / Gryzor	魂斗羅 / Gryzor	Konami
rockrage	戀愛熱搖滾 (世界版?)	戀愛熱搖滾 (世界版?)	Konami
rockraga	戀愛熱搖滾 (Prototype?)	戀愛熱搖滾 (Prototype?)	Konami
rockragj	戀愛熱搖滾 (日版)	戀愛熱搖滾 (日版)	Konami
hcastle	惡魔城 (version M)	惡魔城 (version M)	Konami
hcastleo	惡魔城 (version K)	惡魔城 (version K)	Konami
hcastlej	惡魔城 (日版 version P)	惡魔城 (日版 version P)	Konami
hcastljo	惡魔城 (日版 version N)	惡魔城 (日版 version N)	Konami
ajax	颶風直升機	颶風直升機	Konami
typhoon	颶風直升機	颶風直升機	Konami
ajaxj	颶風直升機 (日版)	颶風直升機 (日版)	Konami
scontra	超級魂斗羅	超級魂斗羅	Konami
scontraj	超級魂斗羅 (日版)	超級魂斗羅 (日版)	Konami
thunderx	雷霆戰機	雷霆戰機	Konami
thnderxa	雷霆戰機 (Set 2)	雷霆戰機 (Set 2)	Konami
thnderxj	雷霆戰機 (日版)	雷霆戰機 (日版)	Konami
devstors	餓流禍 / 破壞者 (ver. Z)	餓流禍 / 破壞者 (ver. Z)	Konami
devstor2	餓流禍 / 破壞者 (ver. X)	餓流禍 / 破壞者 (ver. X)	Konami
devstor3	餓流禍 / 破壞者 (ver. V)	餓流禍 / 破壞者 (ver. V)	Konami
garuka	餓流禍 (日版 ver. W)	餓流禍 (日版 ver. W)	Konami
gbusters	瘋狂警察	瘋狂警察	Konami
crazycop	瘋狂警察 (日版)	瘋狂警察 (日版)	Konami
crimfght	罪惡戰士 (美版 4 players)	罪惡戰士 (美版 4 players)	Konami
crimfgt2	罪惡戰士 (世界版 2 Players)	罪惡戰士 (世界版 2 Players)	Konami
crimfgtj	罪惡戰士 (日版 2 Players)	罪惡戰士 (日版 2 Players)	Konami
spy	S.P.Y. - 特別計劃 Y (世界版 ver. N)	S.P.Y. - 特別計劃 Y (世界版 ver. N)	Konami
spyu	S.P.Y. - 特別計劃 Y (美版 ver. M)	S.P.Y. - 特別計劃 Y (美版 ver. M)	Konami
aliens	異形 (世界版 set 1)	異形 (世界版 set 1)	Konami
aliens2	異形 (世界版 set 2)	異形 (世界版 set 2)	Konami
aliens3	異形 (世界版 set 3)	異形 (世界版 set 3)	Konami
aliensu	異形 (美版)	異形 (美版)	Konami
aliensj	異形 (日版 set 1)	異形 (日版 set 1)	Konami
aliensj2	異形 (日版 set 2)	異形 (日版 set 2)	Konami
parodius	瘋狂大射擊 DA! (世界版)	瘋狂大射擊 DA! (世界版)	Konami
parodisj	瘋狂大射擊 DA! (日版)	瘋狂大射擊 DA! (日版)	Konami
vendetta	復仇 2 (世界版 4 Players ver. T)	復仇 2 (世界版 4 Players ver. T)	Konami
vendetao	復仇 2 (世界版 4 Players ver. R)	復仇 2 (世界版 4 Players ver. R)	Konami
vendet2p	復仇 2 (世界版 2 Players ver. W)	復仇 2 (世界版 2 Players ver. W)	Konami
vendetas	復仇 2 (亞洲版 2 Players ver. U)	復仇 2 (亞洲版 2 Players ver. U)	Konami
vendtaso	復仇 2 (亞洲版 2 Players ver. D)	復仇 2 (亞洲版 2 Players ver. D)	Konami
vendettj	復仇 2 / Crime Fighters 2 (日版 2 Players ver. P)	復仇 2 / Crime Fighters 2 (日版 2 Players ver. P)	Konami
hotchase	公路熱擊	公路熱擊	Konami
ultraman	鹹蛋超人 (日版)	鹹蛋超人 (日版)	Banpresto/Bandai
nemesis	宇宙巡航機 / 復仇女神	宇宙巡航機 / 復仇女神	Konami
nemesuk	宇宙巡航機 / 復仇女神 (世界版?)	宇宙巡航機 / 復仇女神 (世界版?)	Konami
salamand	沙羅曼蛇 (version D)	沙羅曼蛇 (version D)	Konami
salamanj	沙羅曼蛇 (version J)	沙羅曼蛇 (version J)	Konami
lifefrce	沙羅曼蛇 (美版)	沙羅曼蛇 (美版)	Konami
lifefrcj	沙羅曼蛇 (日版)	沙羅曼蛇 (日版)	Konami
twinbee	兵蜂	兵蜂	Konami
gradius	宇宙巡航機	宇宙巡航機	Konami
gwarrior	銀河戰士	銀河戰士	Konami
devilw	魔獸王國 / Devil World	魔獸王國 / Devil World	Konami
darkadv	魔獸王國 / Dark Adventure	魔獸王國 / Dark Adventure	Konami
majuu	魔獸王國	魔獸王國	Konami
vulcan	宇宙巡航機 II / Vulcan Venture	宇宙巡航機 II / Vulcan Venture	Konami
gradius2	宇宙巡航機 II (日版 新版)	宇宙巡航機 II (日版 新版)	Konami
grdius2a	宇宙巡航機 II (日版 舊版)	宇宙巡航機 II (日版 舊版)	Konami
grdius2b	宇宙巡航機 II (日版 更舊版)	宇宙巡航機 II (日版 更舊版)	Konami
miaj	綠色兵團 2 (日版)	綠色兵團 2 (日版)	Konami
mia	綠色兵團 2 (version T)	綠色兵團 2 (version T)	Konami
mia2	綠色兵團 2 (version S)	綠色兵團 2 (version S)	Konami
tmnt	忍者龜 (世界版 4 Players)	忍者龜 (世界版 4 Players)	Konami
tmntu	忍者龜 (美版 4 Players, set 1)	忍者龜 (美版 4 Players, set 1)	Konami
tmntua	忍者龜 (美版 4 Players, set 2)	忍者龜 (美版 4 Players, set 2)	Konami
tmht	忍者龜 (英國版 4 Players)	忍者龜 (英國版 4 Players)	Konami
tmntj	忍者龜 (日版 4 Players)	忍者龜 (日版 4 Players)	Konami
tmht2p	忍者龜 (英國版 2 Players)	忍者龜 (英國版 2 Players)	Konami
tmnt2pj	忍者龜 (日版 2 Players)	忍者龜 (日版 2 Players)	Konami
tmnt2po	忍者龜 (大洋洲版 2 Players)	忍者龜 (大洋洲版 2 Players)	Konami
lgtnfght	火龍 (世界版)	火龍 (世界版)	Konami
lgtnfghu	火龍 (美版)	火龍 (美版)	Konami
trigon	火龍 (日版)	火龍 (日版)	Konami
blswhstl	出發!! 兵蜂 / Bells & Whistles (Version L)	出發!! 兵蜂 / Bells & Whistles (Version L)	Konami
detatwin	出發!! 兵蜂 (日版 ver. J)	出發!! 兵蜂 (日版 ver. J)	Konami
tmnt2	忍者龜 2 - Turtles in Time (4 Players ver UAA)	忍者龜 2 - Turtles in Time (4 Players ver UAA)	Konami
tmnt22p	忍者龜 2 - Turtles in Time (2 Players ver UDA)	忍者龜 2 - Turtles in Time (2 Players ver UDA)	Konami
tmnt2a	忍者龜 2 - Turtles in Time (4 Players ver ADA)	忍者龜 2 - Turtles in Time (4 Players ver ADA)	Konami
ssriders	落日騎士 / 西部牛仔 (4 Players ver EAC)	落日騎士 / 西部牛仔 (4 Players ver EAC)	Konami
ssrdrebd	落日騎士 / 西部牛仔 (2 Players ver EBD)	落日騎士 / 西部牛仔 (2 Players ver EBD)	Konami
ssrdrebc	落日騎士 / 西部牛仔 (2 Players ver EBC)	落日騎士 / 西部牛仔 (2 Players ver EBC)	Konami
ssrdruda	落日騎士 / 西部牛仔 (4 Players ver UDA)	落日騎士 / 西部牛仔 (4 Players ver UDA)	Konami
ssrdreaa	落日騎士 / 西部牛仔 (4 Players ver EAA)	落日騎士 / 西部牛仔 (4 Players ver EAA)	Konami
ssrdruac	落日騎士 / 西部牛仔 (4 Players ver UAC)	落日騎士 / 西部牛仔 (4 Players ver UAC)	Konami
ssrdrubc	落日騎士 / 西部牛仔 (2 Players ver UBC)	落日騎士 / 西部牛仔 (2 Players ver UBC)	Konami
ssrdrabd	落日騎士 / 西部牛仔 (2 Players ver ABD)	落日騎士 / 西部牛仔 (2 Players ver ABD)	Konami
ssrdradd	落日騎士 / 西部牛仔 (4 Players ver ADD)	落日騎士 / 西部牛仔 (4 Players ver ADD)	Konami
ssrdrjbd	落日騎士 / 西部牛仔 (2 Players ver JBD)	落日騎士 / 西部牛仔 (2 Players ver JBD)	Konami
sunsetbl	落日騎士 / 西部牛仔 (bootleg 4 Players ver ADD)	落日騎士 / 西部牛仔 (bootleg 4 Players ver ADD)	Konami
xmen	特異功能組 (4 Players ver UBB)	特異功能組 (4 Players ver UBB)	Konami
xmen2p	特異功能組 (2 Players ver AAA)	特異功能組 (2 Players ver AAA)	Konami
xmen2pj	特異功能組 (2 Players ver JAA)	特異功能組 (2 Players ver JAA)	Konami
xmen6p	特異功能組 (6 Players ver ECB)	特異功能組 (6 Players ver ECB)	Konami
xmen6pu	特異功能組 (6 Players ver UCB)	特異功能組 (6 Players ver UCB)	Konami
gijoe	特種部隊 (世界版)	特種部隊 (世界版)	Konami
gijoeu	特種部隊 (美版)	特種部隊 (美版)	Konami
gijoej	特種部隊 (日版)	特種部隊 (日版)	Konami
thndrx2	雷霆戰機 II (日版)	雷霆戰機 II (日版)	Konami
thndrx2a	雷霆戰機 II (亞洲版)	雷霆戰機 II (亞洲版)	Konami
prmrsocr	頂級足球 (ver EAB)	頂級足球 (ver EAB)	Konami
prmrsocj	頂級足球 (ver JAB)	頂級足球 (ver JAB)	Konami
gaiapols	黃金鷹之劍 (ver EAF)	黃金鷹之劍 (ver EAF)	Konami
gaiapolu	黃金鷹之劍 (ver UAF)	黃金鷹之劍 (ver UAF)	Konami
gaiapolj	黃金鷹之劍 (ver JAF)	黃金鷹之劍 (ver JAF)	Konami
mmaulers	究極戰隊 (ver EAA)	究極戰隊 (ver EAA)	Konami
dadandrn	究極戰隊 (ver JAA)	究極戰隊 (ver JAA)	Konami
dbz	七龍珠 Z	七龍珠 Z	Banpresto
dbz2	七龍珠 Z 2 - 超武鬥大會	七龍珠 Z 2 - 超武鬥大會	Banpresto
gradius3	宇宙巡航機 III (日版)	宇宙巡航機 III (日版)	Konami
grdius3a	宇宙巡航機 III (亞洲版)	宇宙巡航機 III (亞洲版)	Konami
grdius3e	宇宙巡航機 III (世界版 ?)	宇宙巡航機 III (世界版 ?)	Konami
gokuparo	極上瘋狂大射擊 (ver JAD)	極上瘋狂大射擊 (ver JAD)	Konami
fantjour	極上瘋狂大射擊 / Fantastic Journey	極上瘋狂大射擊 / Fantastic Journey	Konami
salmndr2	沙羅曼蛇 2 (ver JAA)	沙羅曼蛇 2 (ver JAA)	Konami
sexyparo	性感瘋狂大射擊 (ver JAA)	性感瘋狂大射擊 (ver JAA)	Konami
gradius4	宇宙巡航艦 4	宇宙巡航艦 4	Konami
thrilld	驚悚駕駛	驚悚駕駛	Konami
chiller	毛骨悚然 (version 3.0)	毛骨悚然 (version 3.0)	Exidy
topsecex	生化指令 / 最高機密 (Exidy) (version 1.0)	生化指令 / 最高機密 (Exidy) (version 1.0)	Exidy
dominos	多米諾骨牌	多米諾骨牌	Atari
ultratnk	終極坦克	終極坦克	Atari
abaseb	雅達利棒球 (set 1)	雅達利棒球 (set 1)	Atari
abaseb2	雅達利棒球 (set 2)	雅達利棒球 (set 2)	Atari
soccer	Atari 足球	Atari 足球	Atari
missile	導彈指令 (set 1)	導彈指令 (set 1)	Atari
missile2	導彈指令 (set 2)	導彈指令 (set 2)	Atari
suprmatk	導彈指令 / Super Missile Attack (for set 2)	導彈指令 / Super Missile Attack (for set 2)	Atari + Gencomp
tempest	暴風雨 (rev 3)	暴風雨 (rev 3)	Atari
tempest1	暴風雨 (rev 1)	暴風雨 (rev 1)	Atari
tempest2	暴風雨 (rev 2)	暴風雨 (rev 2)	Atari
tempest3	暴風雨 (rev ?)	暴風雨 (rev ?)	Atari
temptube	暴風雨 Tubes	暴風雨 Tubes	hack
starwars	星際大戰 (rev 2)	星際大戰 (rev 2)	Atari
starwar1	星際大戰 (rev 1)	星際大戰 (rev 1)	Atari
esb	星際大戰 - 帝國的反擊	星際大戰 - 帝國的反擊	Atari Games
foodf	食物大戰 (rev 3)	食物大戰 (rev 3)	Atari
foodf2	食物大戰 (rev 2)	食物大戰 (rev 2)	Atari
foodfc	食物大戰 (檯面型)	食物大戰 (檯面型)	Atari
ccastles	水晶城堡 (version 4)	水晶城堡 (version 4)	Atari
ccastle3	水晶城堡 (version 3)	水晶城堡 (version 3)	Atari
ccastle2	水晶城堡 (version 2)	水晶城堡 (version 2)	Atari
jedi	星際大戰 / Jedi 歸來	星際大戰 / Jedi 歸來	Atari
marble	瘋狂彈珠 (set 1)	瘋狂彈珠 (set 1)	Atari Games
marble2	瘋狂彈珠 (set 2)	瘋狂彈珠 (set 2)	Atari Games
marble3	瘋狂彈珠 (set 3)	瘋狂彈珠 (set 3)	Atari Games
marble4	瘋狂彈珠 (set 4)	瘋狂彈珠 (set 4)	Atari Games
indytemp	印第安那瓊斯和毀滅之殿 (set 1)	印第安那瓊斯和毀滅之殿 (set 1)	Atari Games
indytem2	印第安那瓊斯和毀滅之殿 (set 2)	印第安那瓊斯和毀滅之殿 (set 2)	Atari Games
indytem3	印第安那瓊斯和毀滅之殿 (set 3)	印第安那瓊斯和毀滅之殿 (set 3)	Atari Games
indytem4	印第安那瓊斯和毀滅之殿 (set 4)	印第安那瓊斯和毀滅之殿 (set 4)	Atari Games
indytemd	印第安那瓊斯和毀滅之殿 (德文)	印第安那瓊斯和毀滅之殿 (德文)	Atari Games
apb	APB - 全國大搜查 (rev 7)	APB - 全國大搜查 (rev 7)	Atari Games
apb6	APB - 全國大搜查 (rev 6)	APB - 全國大搜查 (rev 6)	Atari Games
apb5	APB - 全國大搜查 (rev 5)	APB - 全國大搜查 (rev 5)	Atari Games
apb4	APB - 全國大搜查 (rev 4)	APB - 全國大搜查 (rev 4)	Atari Games
apb3	APB - 全國大搜查 (rev 3)	APB - 全國大搜查 (rev 3)	Atari Games
apb2	APB - 全國大搜查 (rev 2)	APB - 全國大搜查 (rev 2)	Atari Games
apb1	APB - 全國大搜查 (rev 1)	APB - 全國大搜查 (rev 1)	Atari Games
apbg	APB - 全國大搜查 (德文)	APB - 全國大搜查 (德文)	Atari Games
apbf	APB - 全國大搜查 (法文)	APB - 全國大搜查 (法文)	Atari Games
atetcktl	俄羅斯方塊 (檯面型 set 1)	俄羅斯方塊 (檯面型 set 1)	Atari Games
atetckt2	俄羅斯方塊 (檯面型 set 2)	俄羅斯方塊 (檯面型 set 2)	Atari Games
atetris	俄羅斯方塊 (set 1)	俄羅斯方塊 (set 1)	Atari Games
atetrisa	俄羅斯方塊 (set 2)	俄羅斯方塊 (set 2)	Atari Games
atetrisb	俄羅斯方塊 (bootleg set 1)	俄羅斯方塊 (bootleg set 1)	bootleg
atetrsb2	俄羅斯方塊 (bootleg set 2)	俄羅斯方塊 (bootleg set 2)	bootleg
eprom	機械怪獸大逃亡 (set 1)	機械怪獸大逃亡 (set 1)	Atari Games
eprom2	機械怪獸大逃亡 (set 2)	機械怪獸大逃亡 (set 2)	Atari Games
pitfight	死鬥戰士 (rev 5)	死鬥戰士 (rev 5)	Atari Games
pitfigh4	死鬥戰士 (rev 4)	死鬥戰士 (rev 4)	Atari Games
pitfigh3	死鬥戰士 (rev 3)	死鬥戰士 (rev 3)	Atari Games
pitfighj	死鬥戰士 (日版, 2 players)	死鬥戰士 (日版, 2 players)	Atari Games
pitfighb	死鬥戰士 (bootleg)	死鬥戰士 (bootleg)	Atari Games
batman	蝙蝠俠	蝙蝠俠	Atari Games
relief	替補投手 (set 1)	替補投手 (set 1)	Atari Games
relief2	替補投手 (set 2)	替補投手 (set 2)	Atari Games
arcadecl	街機經典名作 (prototype)	街機經典名作 (prototype)	Atari Games
fantasy	幻想 (世界版)	幻想 (世界版)	SNK
fantasyu	幻想 (美版)	幻想 (美版)	[SNK] (Rock-Ola license)
fantasyj	幻想 (日版)	幻想 (日版)	SNK
sgladiat	劍鬥士 1984	劍鬥士 1984	SNK
aso	ASO - 組合戰機	ASO - 組合戰機	SNK
tnk3	大坦克 III (美版)	大坦克 III (美版)	SNK
tnk3j	大坦克 III / T.A.N.K. (日版)	大坦克 III / T.A.N.K. (日版)	SNK
ikari	怒 (美版)	怒 (美版)	SNK
ikarijp	怒 (日版)	怒 (日版)	SNK
ikarijpb	怒 (日版 bootleg)	怒 (日版 bootleg)	bootleg
victroad	怒號層圈 / 勝利之路	怒號層圈 / 勝利之路	SNK
dogosoke	怒號層圈	怒號層圈	SNK
dogosokj	怒號層圈 (搖桿 bootleg)	怒號層圈 (搖桿 bootleg)	bootleg
gwar	革命英雄 (美版)	革命英雄 (美版)	SNK
gwarj	革命英雄 / Guevara (日版)	革命英雄 / Guevara (日版)	SNK
gwara	革命英雄 (Version 1)	革命英雄 (Version 1)	SNK
gwarb	革命英雄 (bootleg)	革命英雄 (bootleg)	bootleg
bermudat	百慕達魔鬼三角 (日版)	百慕達魔鬼三角 (日版)	SNK
bermudao	百慕達魔鬼三角 (日版 old version)	百慕達魔鬼三角 (日版 old version)	SNK
bermudaa	百慕達魔鬼三角 (美版 older version)	百慕達魔鬼三角 (美版 older version)	SNK
worldwar	百慕達魔鬼三角 / 世界大戰 (世界版)	百慕達魔鬼三角 / 世界大戰 (世界版)	SNK
psychos	超能力戰士 (美版)	超能力戰士 (美版)	SNK
psychosj	超能力戰士 (日版)	超能力戰士 (日版)	SNK
chopper	航空騎兵物語 (美版 set 1)	航空騎兵物語 (美版 set 1)	SNK
choppera	航空騎兵物語 (美版 set 2)	航空騎兵物語 (美版 set 2)	SNK
chopperb	航空騎兵物語 (美版 set 3)	航空騎兵物語 (美版 set 3)	SNK
legofair	航空騎兵物語 (日版)	航空騎兵物語 (日版)	SNK
ikari3	怒 III	怒 III	SNK
pow	脫獄 - 戰俘 (美版)	脫獄 - 戰俘 (美版)	SNK
powj	脫獄 - 戰俘 (日版)	脫獄 - 戰俘 (日版)	SNK
searchar	異形大作戰 / SAR - 搜救 (世界版)	異形大作戰 / SAR - 搜救 (世界版)	SNK
sercharu	異形大作戰 / SAR - 搜救 (美版)	異形大作戰 / SAR - 搜救 (美版)	SNK
sercharj	異形大作戰 / SAR - 搜救 (日版)	異形大作戰 / SAR - 搜救 (日版)	SNK
prehisle	原始島 1930 (世界版)	原始島 1930 (世界版)	SNK
prehislu	原始島 1930 (美版)	原始島 1930 (美版)	SNK of America
gensitou	原始島 1930	原始島 1930	SNK
nam1975	越戰-1975	越戰-1975	SNK
bstars	棒球之星	棒球之星	SNK
tpgolf	頂尖高爾夫	頂尖高爾夫	SNK
mahretsu	麻雀狂列傳 西日本篇	麻雀狂列傳 西日本篇	SNK
maglord	幻魔大戰 (set 1)	幻魔大戰 (set 1)	Alpha Denshi Co.
maglordh	幻魔大戰 (set 2)	幻魔大戰 (set 2)	Alpha Denshi Co.
ridhero	風速英雄 (set 1)	風速英雄 (set 1)	SNK
ridheroh	風速英雄 (set 2)	風速英雄 (set 2)	SNK
alpham2	Alpha 任務 II / ASO II - 最後的守護神	Alpha 任務 II / ASO II - 最後的守護神	SNK
ncombat	忍者大戰 (set 1)	忍者大戰 (set 1)	Alpha Denshi Co.
ncombata	忍者大戰 (set 2)	忍者大戰 (set 2)	Alpha Denshi Co.
cyberlip	戰鬥邊緣	戰鬥邊緣	SNK
superspy	諜報飛龍	諜報飛龍	SNK
mutnat	外星遊龍	外星遊龍	SNK
kotm	魔獸之王 (set 1)	魔獸之王 (set 1)	SNK
kotmh	魔獸之王 (set 2)	魔獸之王 (set 2)	SNK
sengoku	戰國傳承 (set 1)	戰國傳承 (set 1)	SNK
sengokh	戰國傳承 (set 2)	戰國傳承 (set 2)	SNK
burningf	熱血快打 (set 1)	熱血快打 (set 1)	SNK
burningh	熱血快打 (set 2)	熱血快打 (set 2)	SNK
lbowling	超級保齡球	超級保齡球	SNK
gpilots	幽靈戰區	幽靈戰區	SNK
joyjoy	陽光方塊	陽光方塊	SNK
bjourney	拉吉少年	拉吉少年	Alpha Denshi Co.
quizdais	解謎偵查線	解謎偵查線	SNK
lresort	終極任務	終極任務	SNK
eightman	8 號超人	8 號超人	SNK / Pallas
minasan	麻雀大賽	麻雀大賽	Monolith Corp.
legendos	小拳王	小拳王	SNK
2020bb	2020 年未來棒球 (set 1)	2020 年未來棒球 (set 1)	SNK / Pallas
2020bba	2020 年未來棒球 (set 2)	2020 年未來棒球 (set 2)	SNK / Pallas
2020bbh	2020 年未來棒球 (set 3)	2020 年未來棒球 (set 3)	SNK / Pallas
socbrawl	機器人足球	機器人足球	SNK
roboarmy	機甲神兵 (set 1)	機甲神兵 (set 1)	SNK
roboarma	機甲神兵 (set 2)	機甲神兵 (set 2)	SNK
fatfury1	餓狼傳說	餓狼傳說	SNK
fbfrenzy	瘋狂美式足球	瘋狂美式足球	SNK
bakatono	傻瓜殿下麻雀漫遊記	傻瓜殿下麻雀漫遊記	Monolith Corp.
crsword	聖十字劍	聖十字劍	Alpha Denshi Co.
trally	極速英豪	極速英豪	Alpha Denshi Co.
kotm2	魔獸之王 2	魔獸之王 2	SNK
sengoku2	戰國傳承 2	戰國傳承 2	SNK
bstars2	棒球之星 2	棒球之星 2	SNK
quizdai2	解謎偵查線 Part 2	解謎偵查線 Part 2	SNK
3countb	火燄摔角	火燄摔角	SNK
aof	龍虎拳	龍虎拳	SNK
samsho	侍魂	侍魂	SNK
tophuntr	頂尖獵人 (set 1)	頂尖獵人 (set 1)	SNK
tophunta	頂尖獵人 (set 2)	頂尖獵人 (set 2)	SNK
fatfury2	餓狼傳說 2	餓狼傳說 2	SNK
janshin	雀神傳說	雀神傳說	Aicom
androdun	雷霆任務	雷霆任務	Visco
ncommand	忍者戰士	忍者戰士	Alpha Denshi Co.
viewpoin	視點 / V 計劃	視點 / V 計劃	Sammy
ssideki	得點王	得點王	SNK
wh1	英雄榜 (set 1)	英雄榜 (set 1)	Alpha Denshi Co.
wh1h	英雄榜 (set 2)	英雄榜 (set 2)	Alpha Denshi Co.
kof94	拳皇 '94	拳皇 '94	SNK
aof2	龍虎拳 2 (set 1)	龍虎拳 2 (set 1)	SNK
aof2a	龍虎拳 2 (set 2)	龍虎拳 2 (set 2)	SNK
wh2	英雄榜 2	英雄榜 2	ADK
fatfursp	餓狼傳說 特別版 (set 1)	餓狼傳說 特別版 (set 1)	SNK
fatfursa	餓狼傳說 特別版 (set 2)	餓狼傳說 特別版 (set 2)	SNK
savagere	風雲默示錄 - 格鬥創世	風雲默示錄 - 格鬥創世	SNK
fightfev	狂熱戰鬥 (set 1)	狂熱戰鬥 (set 1)	Viccom
fightfva	狂熱戰鬥 (set 2)	狂熱戰鬥 (set 2)	Viccom
ssideki2	得點王 2	得點王 2	SNK
spinmast	強尼大冒險	強尼大冒險	Data East Corporation
samsho2	侍魂 II / 真侍魂 - 霸王丸地獄變	侍魂 II / 真侍魂 - 霸王丸地獄變	SNK
wh2j	英雄榜 2 Jet	英雄榜 2 Jet	ADK / SNK
wjammers	超級飛碟球	超級飛碟球	Data East Corporation
karnovr	格鬥列傳	格鬥列傳	Data East Corporation
gururin	旋轉方塊	旋轉方塊	Face
pspikes2	超級排球 II	超級排球 II	Video System Co.
fatfury3	餓狼傳說 3	餓狼傳說 3	SNK
panicbom	轟炸超人方塊	轟炸超人方塊	Eighting / Hudson
aodk	熱血進行曲	熱血進行曲	ADK / SNK
sonicwi2	音速戰機 2	音速戰機 2	Video System Co.
zedblade	末日之戰	末日之戰	NMK
galaxyfg	銀河快打	銀河快打	Sunsoft
strhoop	夢幻籃球賽	夢幻籃球賽	Data East Corporation
quizkof	拳皇問答	拳皇問答	Saurus
ssideki3	得點王 3	得點王 3	SNK
doubledr	雙截龍 (Neo-Geo)	雙截龍 (Neo-Geo)	Technos
pbobblen	泡泡龍解謎 (Neo-Geo) (set 1)	泡泡龍解謎 (Neo-Geo) (set 1)	Taito
pbobblna	泡泡龍解謎 (Neo-Geo) (set 2)	泡泡龍解謎 (Neo-Geo) (set 2)	Taito
kof95	拳皇 '95 (set 1)	拳皇 '95 (set 1)	SNK
kof95a	拳皇 '95 (set 2)	拳皇 '95 (set 2)	SNK
tws96	Tecmo 世界足球 '96	Tecmo 世界足球 '96	Tecmo
samsho3	侍魂 III - 斬紅郎無雙劍 (set 1)	侍魂 III - 斬紅郎無雙劍 (set 1)	SNK
samsho3a	侍魂 III - 斬紅郎無雙劍 (set 2)	侍魂 III - 斬紅郎無雙劍 (set 2)	SNK
stakwin	騎手之路	騎手之路	Saurus
pulstar	死亡之星	死亡之星	Aicom
whp	英雄榜 完美版	英雄榜 完美版	ADK / SNK
kabukikl	天外魔境真傳	天外魔境真傳	Hudson
neobombe	Neo 轟炸超人	Neo 轟炸超人	Hudson
gowcaizr	超人學園	超人學園	Technos
rbff1	Real Bout 餓狼傳說	Real Bout 餓狼傳說	SNK
aof3	龍虎拳 3	龍虎拳 3	SNK
sonicwi3	音速戰機 3	音速戰機 3	Video System Co.
turfmast	大聯盟高爾夫	大聯盟高爾夫	Nazca
mslug	合金彈頭 / 越南大戰	合金彈頭 / 越南大戰	Nazca
puzzledp	解謎氣泡!	解謎氣泡!	Taito (Visco license)
mosyougi	將棋達人	將棋達人	ADK / SNK
marukodq	小丸子問答	小丸子問答	Takara
neomrdo	Neo 地鼠先生	Neo 地鼠先生	Visco
sdodgeb	超級躲避球	超級躲避球	Technos
overtop	極速賽車	極速賽車	ADK
neodrift	Neo 越野賽車	Neo 越野賽車	Visco
kof96	拳皇 '96 (set 1)	拳皇 '96 (set 1)	SNK
kof96h	拳皇 '96 (set 2)	拳皇 '96 (set 2)	SNK
ssideki4	得點王 4 / The Ultimate 11	得點王 4 / The Ultimate 11	SNK
kizuna	風雲默示錄 2 - 超級組隊戰	風雲默示錄 2 - 超級組隊戰	SNK
ninjamas	霸王忍法帖	霸王忍法帖	ADK / SNK
ragnagrd	神凰拳	神凰拳	Saurus
pgoal	英式足球	英式足球	Saurus
magdrop2	魔法氣泡 II	魔法氣泡 II	Data East Corporation
samsho4	侍魂 IV - 天草降臨	侍魂 IV - 天草降臨	SNK
rbffspec	Real Bout 餓狼傳說 特別版	Real Bout 餓狼傳說 特別版	SNK
twinspri	夢幻小妖精	夢幻小妖精	ADK
wakuwak7	7 戰士	7 戰士	Sunsoft
stakwin2	騎手之路 2	騎手之路 2	Saurus
ghostlop	魔鬼飛行員 (prototype)	魔鬼飛行員 (prototype)	Data East Corporation
breakers	爆烈人	爆烈人	Visco
kof97	拳皇 '97 (set 1)	拳皇 '97 (set 1)	SNK
kof97a	拳皇 '97 (set 2)	拳皇 '97 (set 2)	SNK
kof97pls	拳皇 '97 Plus (bootleg)	拳皇 '97 Plus (bootleg)	bootleg
magdrop3	魔法氣泡 III	魔法氣泡 III	Data East Corporation
lastblad	幕末浪漫 - 月華劍士 (set 1)	幕末浪漫 - 月華劍士 (set 1)	SNK
lastblda	幕末浪漫 - 月華劍士 (set 2)	幕末浪漫 - 月華劍士 (set 2)	SNK
puzzldpr	解謎氣泡! R!	解謎氣泡! R!	Taito (Visco license)
irrmaze	電流急急棒	電流急急棒	SNK / Saurus
popbounc	動物方塊	動物方塊	Video System Co.
shocktro	突擊騎兵 (set 1)	突擊騎兵 (set 1)	Saurus
shocktra	突擊騎兵 (set 2)	突擊騎兵 (set 2)	Saurus
blazstar	燃燒之星	燃燒之星	Yumekobo
rbff2	Real Bout 餓狼傳說 2 - 新挑戰者 (set 1)	Real Bout 餓狼傳說 2 - 新挑戰者 (set 1)	SNK
rbff2a	Real Bout 餓狼傳說 2 - 新挑戰者 (set 2)	Real Bout 餓狼傳說 2 - 新挑戰者 (set 2)	SNK
mslug2	合金彈頭 2 / 越南大戰 2	合金彈頭 2 / 越南大戰 2	SNK
kof98	拳皇 '98 - 夢幻戰役	拳皇 '98 - 夢幻戰役	SNK
kof98k	拳皇 '98 - 夢幻戰役 (Korean board)	拳皇 '98 - 夢幻戰役 (Korean board)	SNK
kof98n	拳皇 '98 - 夢幻戰役 (not encrypted)	拳皇 '98 - 夢幻戰役 (not encrypted)	SNK
lastbld2	幕末浪漫 月華劍士 2	幕末浪漫 月華劍士 2	SNK
neocup98	Neo-Geo 盃足球賽 '98 - 勝利之路	Neo-Geo 盃足球賽 '98 - 勝利之路	SNK
breakrev	爆烈人 復仇	爆烈人 復仇	Visco
shocktr2	突擊騎兵 2 - 第二縱隊	突擊騎兵 2 - 第二縱隊	Saurus
flipshot	盾牌大戰	盾牌大戰	Visco
pbobbl2n	泡泡龍解謎 2 (Neo-Geo)	泡泡龍解謎 2 (Neo-Geo)	Taito (SNK license)
ctomaday	蕃茄大作戰	蕃茄大作戰	Visco
mslugx	合金彈頭 X / 越南大戰 X	合金彈頭 X / 越南大戰 X	SNK
kof99	拳皇 '99 - 千禧年之戰 (set 1)	拳皇 '99 - 千禧年之戰 (set 1)	SNK
kof99a	拳皇 '99 - 千禧年之戰 (set 2)	拳皇 '99 - 千禧年之戰 (set 2)	SNK
kof99e	拳皇 '99 - 千禧年之戰 (earlier)	拳皇 '99 - 千禧年之戰 (earlier)	SNK
kof99n	拳皇 '99 - 千禧年之戰 (not encrypted)	拳皇 '99 - 千禧年之戰 (not encrypted)	SNK
kof99p	拳皇 '99 - 千禧年之戰 (prototype)	拳皇 '99 - 千禧年之戰 (prototype)	SNK
ganryu	武藏嚴流記	武藏嚴流記	Visco
garou	餓狼 - 群狼之證 (set 1)	餓狼 - 群狼之證 (set 1)	SNK
garouo	餓狼 - 群狼之證 (set 2)	餓狼 - 群狼之證 (set 2)	SNK
garoup	餓狼 - 群狼之證 (prototype)	餓狼 - 群狼之證 (prototype)	SNK
s1945p	打擊者 1945 Plus	打擊者 1945 Plus	Psikyo
preisle2	原始島 2	原始島 2	Yumekobo
mslug3	合金彈頭 3 / 越南大戰 3	合金彈頭 3 / 越南大戰 3	SNK
mslug3n	合金彈頭 3 / 越南大戰 3 (not encrypted)	合金彈頭 3 / 越南大戰 3 (not encrypted)	SNK
kof2000	拳皇 2000	拳皇 2000	SNK
kof2000n	拳皇 2000 (not encrypted)	拳皇 2000 (not encrypted)	SNK
bangbead	衝擊彈珠	衝擊彈珠	Visco
nitd	黑暗守墓者	黑暗守墓者	Eleven / Gavaking
sengoku3	戰國傳承 3	戰國傳承 3	SNK
kof2001	拳皇 2001 (set 1)	拳皇 2001 (set 1)	Eolith / SNK
kof2001h	拳皇 2001 (set 2)	拳皇 2001 (set 2)	Eolith / SNK
mslug4	合金彈頭 4 / 越南大戰 4	合金彈頭 4 / 越南大戰 4	Mega
ms4plus	合金彈頭 4 Plus / 越南大戰 4 Plus (bootleg)	合金彈頭 4 Plus / 越南大戰 4 Plus (bootleg)	bootleg
rotd	龍拳	龍拳	Evoga / Playmore
kof2002	拳皇 2002	拳皇 2002	Eolith / Playmore
matrim	新豪血寺一族 - 鬥婚	新豪血寺一族 - 鬥婚	Noise Factory / Atlus
diggerma	挖掘人	挖掘人	Unknown
kof99nd	拳皇 '99 - 千禧年之戰 (non encrypted P,decrypted C)	拳皇 '99 - 千禧年之戰 (non encrypted P,decrypted C)	SNK
ganryud	武藏嚴流記 (decrypted C)	武藏嚴流記 (decrypted C)	Visco
garoud	餓狼 - 群狼之證 (decrypted C)	餓狼 - 群狼之證 (decrypted C)	SNK
s1945pd	打擊者 1945 Plus (decrypted C)	打擊者 1945 Plus (decrypted C)	Psikyo
preisl2d	原始島 2 (decrypted C)	原始島 2 (decrypted C)	Yumekobo
mslug3nd	合金彈頭 3 / 越南大戰 3 (non encrypted P,decrypted C)	合金彈頭 3 / 越南大戰 3 (non encrypted P,decrypted C)	SNK
kof2000d	拳皇 2000 (non encrypted P,decrypted C)	拳皇 2000 (non encrypted P,decrypted C)	SNK
nitdd	黑暗守墓者 (decrypted C)	黑暗守墓者 (decrypted C)	Eleven / Gavaking
sengok3d	戰國傳承 3 (decrypted P,decrypted C)	戰國傳承 3 (decrypted P,decrypted C)	SNK
shougi	將棋	將棋	Alpha Denshi
shougi2	將棋 2	將棋 2	Alpha Denshi
champbas	冠軍棒球	冠軍棒球	Sega
champbbj	冠軍棒球 (日版 set 1)	冠軍棒球 (日版 set 1)	Alpha Denshi Co.
champbja	冠軍棒球 (日版 set 2)	冠軍棒球 (日版 set 2)	Alpha Denshi Co.
champbb2	冠軍棒球 II (set 1)	冠軍棒球 II (set 1)	Sega
champb2a	冠軍棒球 II (set 2)	冠軍棒球 II (set 2)	Alpha Denshi Co.
exctsccr	奮鬥足球	奮鬥足球	Alpha Denshi Co.
exctscca	奮鬥足球 (alternate music)	奮鬥足球 (alternate music)	Alpha Denshi Co.
exctsccb	奮鬥足球 (bootleg)	奮鬥足球 (bootleg)	bootleg
exctscc2	奮鬥足球 II	奮鬥足球 II	Alpha Denshi Co.
kouyakyu	高校野球	高校野球	Alpha Denshi Co.
skysoldr	空中騎士 (美版)	空中騎士 (美版)	[Alpha Denshi Co.] (SNK of America/Romstar license)
skyadvnt	天空大冒險 (世界版)	天空大冒險 (世界版)	Alpha Denshi Co.
skyadvnu	天空大冒險 (美版)	天空大冒險 (美版)	Alpha Denshi Co. (SNK of America license)
skyadvnj	天空大冒險 (日版)	天空大冒險 (日版)	Alpha Denshi Co.
gangwars	群毆 (美版)	群毆 (美版)	Alpha Denshi Co.
gangwarb	群毆 (bootleg)	群毆 (bootleg)	bootleg
ssozumo	出世大相撲 (日版)	出世大相撲 (日版)	Technos
mystston	秘石 - Dr. John's Adventure	秘石 - Dr. John's Adventure	Technos
myststno	秘石 - Dr. Kick in Adventure	秘石 - Dr. Kick in Adventure	Technos
matmania	奮鬥時刻 / Mat Mania	奮鬥時刻 / Mat Mania	Technos (Taito America license)
excthour	奮鬥時刻	奮鬥時刻	Technos (Taito license)
renegade	熱血硬派 (美版)	熱血硬派 (美版)	Technos (Taito America license)
kuniokun	熱血硬派 (日版)	熱血硬派 (日版)	Technos
kuniokub	熱血硬派 (日版 bootleg)	熱血硬派 (日版 bootleg)	bootleg
ddragon	雙截龍 (日版)	雙截龍 (日版)	Technos
ddragonu	雙截龍 (美版)	雙截龍 (美版)	[Technos] (Taito America license)
ddragonw	雙截龍 (世界版)	雙截龍 (世界版)	[Technos] (Taito license)
ddragonb	雙截龍 (bootleg)	雙截龍 (bootleg)	bootleg
spdodgeb	熱血高校躲避球 (美版)	熱血高校躲避球 (美版)	Technos
nkdodgeb	熱血高校躲避球 (日版 bootleg)	熱血高校躲避球 (日版 bootleg)	Technos
chinagat	西遊降魔錄 - 流棒妖技之章 (美版)	西遊降魔錄 - 流棒妖技之章 (美版)	[Technos] (Taito Romstar license)
saiyugou	西遊降魔錄 - 流棒妖技之章 (日版)	西遊降魔錄 - 流棒妖技之章 (日版)	Technos
saiyugb1	西遊降魔錄 - 流棒妖技之章 (日版 bootleg 1)	西遊降魔錄 - 流棒妖技之章 (日版 bootleg 1)	bootleg
saiyugb2	西遊降魔錄 - 流棒妖技之章 (日版 bootleg 2)	西遊降魔錄 - 流棒妖技之章 (日版 bootleg 2)	bootleg
wwfsstar	WWF 超級明星 (歐洲版)	WWF 超級明星 (歐洲版)	Technos Japan
wwfsstau	WWF 超級明星 (美版)	WWF 超級明星 (美版)	Technos Japan
wwfsstaj	WWF 超級明星 (日版)	WWF 超級明星 (日版)	Technos Japan
vball	U.S. 沙灘排球錦標賽 (set 1)	U.S. 沙灘排球錦標賽 (set 1)	Technos
vball2pj	U.S. 沙灘排球錦標賽 (日版)	U.S. 沙灘排球錦標賽 (日版)	Technos
ddragon2	雙截龍 II - 復仇 (世界版)	雙截龍 II - 復仇 (世界版)	Technos
ddragn2u	雙截龍 II - 復仇 (美版)	雙截龍 II - 復仇 (美版)	Technos
ctribe	戰鬥部落 (美版)	戰鬥部落 (美版)	Technos
ctribeb	戰鬥部落 (bootleg)	戰鬥部落 (bootleg)	bootleg
agress	飛彈大戰略	飛彈大戰略	Palco
ddragon3	雙截龍 3 - 羅塞塔之石 (美版)	雙截龍 3 - 羅塞塔之石 (美版)	Technos
ddrago3b	雙截龍 3 - 羅塞塔之石 (bootleg)	雙截龍 3 - 羅塞塔之石 (bootleg)	bootleg
wwfwfest	WWF 狂熱摔角 (美版 set 1)	WWF 狂熱摔角 (美版 set 1)	Technos Japan
wwfwfsta	WWF 狂熱摔角 (美版 Tecmo)	WWF 狂熱摔角 (美版 Tecmo)	Technos Japan (Tecmo license)
wwfwfstb	WWF 狂熱摔角 (美版 bootleg)	WWF 狂熱摔角 (美版 bootleg)	bootleg
wwfwfstj	WWF 狂熱摔角 (日版)	WWF 狂熱摔角 (日版)	Technos Japan
shadfrce	變身忍者 (美版 Version 2)	變身忍者 (美版 Version 2)	Technos Japan
sia2650	超級入侵者	超級入侵者	Zaccaria/Zelco
tinv2650	超級入侵者 / The Invaders	超級入侵者 / The Invaders	Zaccaria/Zelco
nova2001	Nova 2001 (日版)	Nova 2001 (日版)	UPL
nov2001u	Nova 2001 (美版)	Nova 2001 (美版)	UPL (Universal license)
ninjakun	忍者君 魔城冒險	忍者君 魔城冒險	[UPL] (Taito license)
raiders5	襲擊者 5	襲擊者 5	UPL
raidrs5t	襲擊者 5 (日版)	襲擊者 5 (日版)	UPL (Taito license)
xxmissio	XX 任務	XX 任務	UPL
ninjakd2	忍者君 II 阿修羅之章 (set 1)	忍者君 II 阿修羅之章 (set 1)	UPL
ninjak2a	忍者君 II 阿修羅之章 (set 2)	忍者君 II 阿修羅之章 (set 2)	UPL
ninjak2b	忍者君 II 阿修羅之章 (set 3)	忍者君 II 阿修羅之章 (set 3)	UPL
rdaction	忍者君 II 阿修羅之章 / Rad Action	忍者君 II 阿修羅之章 / Rad Action	UPL (World Games license)
robokid	原子機械人	原子機械人	UPL
robokidj	原子機械人 (日版)	原子機械人 (日版)	UPL
omegaf	Omega 戰機	Omega 戰機	UPL
omegafs	Omega 戰機 特別版	Omega 戰機 特別版	UPL
bioship	宇宙戰艦 / 生化艇遊俠	宇宙戰艦 / 生化艇遊俠	UPL (American Sammy license)
strahl	鋼鐵要塞 Strahl (日版 set 1)	鋼鐵要塞 Strahl (日版 set 1)	UPL
strahla	鋼鐵要塞 Strahl (日版 set 2)	鋼鐵要塞 Strahl (日版 set 2)	UPL
tdragon2	雷龍 2	雷龍 2	NMK
bigbang	雷龍  2 / Big Bang	雷龍  2 / Big Bang	NMK
tdragon	雷龍	雷龍	NMK (Tecmo license)
tdragonb	雷龍 (Bootleg)	雷龍 (Bootleg)	NMK / Tecmo
macross	超時空要塞	超時空要塞	Banpresto
gunnail	炮釘	炮釘	NMK / Tecmo
macross2	超時空要塞 II	超時空要塞 II	Banpresto
nouryoku	腦力向上委員會	腦力向上委員會	Tecmo
ssmissin	S.S. 特命	S.S. 特命	Comad
macrossp	超時空要塞 Plus	超時空要塞 Plus	Banpresto
quizmoon	美少女戰士問答	美少女戰士問答	Banpresto
narc	毒品搜查官 (rev 7.00)	毒品搜查官 (rev 7.00)	Williams
narc3	毒品搜查官 (rev 3.20)	毒品搜查官 (rev 3.20)	Williams
mk	真人快打 / 魔宮帝國 (rev 5.0 T-Unit 03/19/93)	真人快打 / 魔宮帝國 (rev 5.0 T-Unit 03/19/93)	Midway
mkr4	真人快打 / 魔宮帝國 (rev 4.0 T-Unit 02/11/93)	真人快打 / 魔宮帝國 (rev 4.0 T-Unit 02/11/93)	Midway
mkprot9	真人快打 / 魔宮帝國 (prototype, rev 9.0 07/28/92)	真人快打 / 魔宮帝國 (prototype, rev 9.0 07/28/92)	Midway
mkla1	真人快打 / 魔宮帝國 (rev 1.0 08/09/92)	真人快打 / 魔宮帝國 (rev 1.0 08/09/92)	Midway
mkla2	真人快打 / 魔宮帝國 (rev 2.0 08/18/92)	真人快打 / 魔宮帝國 (rev 2.0 08/18/92)	Midway
mkla3	真人快打 / 魔宮帝國 (rev 3.0 08/31/92)	真人快打 / 魔宮帝國 (rev 3.0 08/31/92)	Midway
mkla4	真人快打 / 魔宮帝國 (rev 4.0 09/28/92)	真人快打 / 魔宮帝國 (rev 4.0 09/28/92)	Midway
mkyawdim	真人快打 / 魔宮帝國 (Yawdim bootleg)	真人快打 / 魔宮帝國 (Yawdim bootleg)	Midway
term2	終結者 2 - 世界末日 (rev LA3 03/27/92)	終結者 2 - 世界末日 (rev LA3 03/27/92)	Midway
term2la2	終結者 2 - 世界末日 (rev LA2 12/09/91)	終結者 2 - 世界末日 (rev LA2 12/09/91)	Midway
term2la1	終結者 2 - 世界末日 (rev LA1 11/01/91)	終結者 2 - 世界末日 (rev LA1 11/01/91)	Midway
totcarn	大屠殺 (rev LA1 03/10/92)	大屠殺 (rev LA1 03/10/92)	Midway
totcarnp	大屠殺 (prototype, rev 1.0 01/25/92)	大屠殺 (prototype, rev 1.0 01/25/92)	Midway
mk2	真人快打 II / 魔宮帝國 II (rev L3.1)	真人快打 II / 魔宮帝國 II (rev L3.1)	Midway
mk2r32	真人快打 II / 魔宮帝國 II (rev L3.2 (European))	真人快打 II / 魔宮帝國 II (rev L3.2 (European))	Midway
mk2r21	真人快打 II / 魔宮帝國 II (rev L2.1)	真人快打 II / 魔宮帝國 II (rev L2.1)	Midway
mk2r14	真人快打 II / 魔宮帝國 II (rev L1.4)	真人快打 II / 魔宮帝國 II (rev L1.4)	Midway
mk2r42	真人快打 II / 魔宮帝國 II (rev L4.2, hack)	真人快打 II / 魔宮帝國 II (rev L4.2, hack)	hack
mk2r91	真人快打 II / 魔宮帝國 II (rev L9.1, hack)	真人快打 II / 魔宮帝國 II (rev L9.1, hack)	hack
mk2chal	真人快打 II / 魔宮帝國 II 挑戰者 (hack)	真人快打 II / 魔宮帝國 II 挑戰者 (hack)	hack
nbajam	NBA 籃球 (rev 3.01 04/07/93)	NBA 籃球 (rev 3.01 04/07/93)	Midway
nbajamr2	NBA 籃球 (rev 2.00 02/10/93)	NBA 籃球 (rev 2.00 02/10/93)	Midway
nbajamte	NBA 籃球 TE (rev 4.0 03/23/94)	NBA 籃球 TE (rev 4.0 03/23/94)	Midway
nbajamt1	NBA 籃球 TE (rev 1.0 01/17/94)	NBA 籃球 TE (rev 1.0 01/17/94)	Midway
nbajamt2	NBA 籃球 TE (rev 2.0 01/28/94)	NBA 籃球 TE (rev 2.0 01/28/94)	Midway
nbajamt3	NBA 籃球 TE (rev 3.0 03/04/94)	NBA 籃球 TE (rev 3.0 03/04/94)	Midway
revx	X 革命 (Rev. 1.0 6/16/94)	X 革命 (Rev. 1.0 6/16/94)	Midway
mk3	真人快打 3 / 魔宮帝國 3 (rev 2.1)	真人快打 3 / 魔宮帝國 3 (rev 2.1)	Midway
mk3r20	真人快打 3 / 魔宮帝國 3 (rev 2.0)	真人快打 3 / 魔宮帝國 3 (rev 2.0)	Midway
mk3r10	真人快打 3 / 魔宮帝國 3 (rev 1.0)	真人快打 3 / 魔宮帝國 3 (rev 1.0)	Midway
umk3	真人快打 3 / 終極魔宮帝國 3 (rev 1.2)	真人快打 3 / 終極魔宮帝國 3 (rev 1.2)	Midway
umk3r11	真人快打 3 / 終極魔宮帝國 3 (rev 1.1)	真人快打 3 / 終極魔宮帝國 3 (rev 1.1)	Midway
umk3r10	真人快打 3 / 終極魔宮帝國 3 (rev 1.0)	真人快打 3 / 終極魔宮帝國 3 (rev 1.0)	Midway
wwfmania	WWF: 瘋狂摔角 (rev 1.30 08/10/95)	WWF: 瘋狂摔角 (rev 1.30 08/10/95)	Midway
nbahangt	NBA 懸空瞬間 (rev L1.1 04/16/96)	NBA 懸空瞬間 (rev L1.1 04/16/96)	Midway
nbamht	NBA 最大懸空瞬間 (rev 1.03 06/09/97)	NBA 最大懸空瞬間 (rev 1.03 06/09/97)	Midway
nbamht1	NBA 最大懸空瞬間 (rev 1.0 11/08/96)	NBA 最大懸空瞬間 (rev 1.0 11/08/96)	Midway
armora	武裝襲擊	武裝襲擊	Cinematronics
armorap	武裝襲擊 (prototype)	武裝襲擊 (prototype)	Cinematronics
armorar	武裝襲擊 (Rock-ola)	武裝襲擊 (Rock-ola)	Cinematronics (Rock-ola license)
cchasm	天裂 (set 1)	天裂 (set 1)	Cinematronics / GCE
cchasm1	天裂 (set 2)	天裂 (set 2)	Cinematronics / GCE
sbagman	超級袋子人	超級袋子人	Valadon Automation
sbagmans	超級袋子人 (Stern)	超級袋子人 (Stern)	Valadon Automation (Stern license)
kungfut	功夫大君	功夫大君	Seibu Kaihatsu Inc.
kungfuta	功夫大君 (alt)	功夫大君 (alt)	Seibu Kaihatsu Inc.
empcity	帝都: 1931 (bootleg?)	帝都: 1931 (bootleg?)	Seibu Kaihatsu
empcityu	帝都: 1931 (美版)	帝都: 1931 (美版)	[Seibu Kaihatsu] (Taito / Romstar license)
empcityj	帝都: 1931 (日版)	帝都: 1931 (日版)	[Seibu Kaihatsu] (Taito license)
stfight	帝都: 1931 / Street Fight (德國版)	帝都: 1931 / Street Fight (德國版)	Seibu Kaihatsu
stfighta	帝都: 1931 / Street Fight	帝都: 1931 / Street Fight	Seibu Kaihatsu
dynduke	爆破公爵	爆破公爵	Seibu Kaihatsu (Fabtek license)
dbldyn	爆破公爵 / The Double Dynamites	爆破公爵 / The Double Dynamites	Seibu Kaihatsu (Fabtek license)
raiden	雷電	雷電	Seibu Kaihatsu
raidena	雷電 (Alternate Hardware)	雷電 (Alternate Hardware)	Seibu Kaihatsu
raidenk	雷電 (韓國版)	雷電 (韓國版)	Seibu Kaihatsu (IBL Corporation license)
raident	雷電 (台灣版)	雷電 (台灣版)	Seibu Kaihatsu (Liang HWA Electronics license)
sdgndmps	機動戰士 SD 高達 - Psycho Salamander 的威脅	機動戰士 SD 高達 - Psycho Salamander 的威脅	Banpresto / Bandai
sengokmj	戰國麻雀 (日版)	戰國麻雀 (日版)	Sigma
raiden2	雷電 2 (set 1, 美版 Fabtek)	雷電 2 (set 1, 美版 Fabtek)	Seibu Kaihatsu
raiden2a	雷電 2 (set 2, Metrotainment)	雷電 2 (set 2, Metrotainment)	Seibu Kaihatsu
raiden2b	雷電 2 (set 3, 日版)	雷電 2 (set 3, 日版)	Seibu Kaihatsu
raiden2c	雷電 2 (set 4, 日版)	雷電 2 (set 4, 日版)	Seibu Kaihatsu
raiden2e	雷電 2 (easier?)	雷電 2 (easier?)	Seibu Kaihatsu
raidndx	雷電 DX (set 1)	雷電 DX (set 1)	Seibu Kaihatsu
raidndxa	雷電 DX (set 2)	雷電 DX (set 2)	Seibu Kaihatsu
raidndxb	雷電 DX (set 3, Newer V33 PCB)	雷電 DX (set 3, Newer V33 PCB)	Seibu Kaihatsu
raidndxj	雷電 DX (日版)	雷電 DX (日版)	Seibu Kaihatsu
raidndxm	雷電 DX (Metrotainment license)	雷電 DX (Metrotainment license)	Seibu Kaihatsu
senkyu	戰球 (日版)	戰球 (日版)	Seibu Kaihatsu
senkyua	戰球 (日版, set 2)	戰球 (日版, set 2)	Seibu Kaihatsu
batlball	戰球 (德國版)	戰球 (德國版)	Seibu Kaihatsu (Tuning License)
batlbala	戰球 (亞洲版)	戰球 (亞洲版)	Seibu Kaihatsu (Metrotainment License)
toki	JuJu 傳說 / Toki (世界版 set 1)	JuJu 傳說 / Toki (世界版 set 1)	Tad
tokia	JuJu 傳說 / Toki (世界版 set 2)	JuJu 傳說 / Toki (世界版 set 2)	Tad
tokij	JuJu 傳說 (日版)	JuJu 傳說 (日版)	Tad
tokiu	JuJu 傳說 / Toki (美版)	JuJu 傳說 / Toki (美版)	Tad (Fabtek license)
tokib	JuJu 傳說 / Toki (bootleg)	JuJu 傳說 / Toki (bootleg)	bootleg
skysmash	空中打擊者	空中打擊者	Nihon System
exerion	火鳳凰	火鳳凰	Jaleco
exeriont	火鳳凰 (Taito)	火鳳凰 (Taito)	Jaleco (Taito America license)
exerionb	火鳳凰 (bootleg)	火鳳凰 (bootleg)	Jaleco
momoko	桃子 120%	桃子 120%	Jaleco
ginganin	銀河任俠傳 (set 1)	銀河任俠傳 (set 1)	Jaleco
gingania	銀河任俠傳 (set 2)	銀河任俠傳 (set 2)	Jaleco
f1gpstar	F1 明星汽車大獎賽 / Grand Prix Star	F1 明星汽車大獎賽 / Grand Prix Star	Jaleco
f1gpstr2	F1 明星汽車大獎賽 II / F-1 Grand Prix Star II	F1 明星汽車大獎賽 II / F-1 Grand Prix Star II	Jaleco
tetrisp2	俄羅斯方塊 Plus 2 (世界版?)	俄羅斯方塊 Plus 2 (世界版?)	Jaleco / The Tetris Company
teplus2j	俄羅斯方塊 Plus 2 (日版)	俄羅斯方塊 Plus 2 (日版)	Jaleco / The Tetris Company
lomakai	魔魁傳說 (世界版)	魔魁傳說 (世界版)	Jaleco
makaiden	魔魁傳說 (日版)	魔魁傳說 (日版)	Jaleco
p47	P-47 - 幻影戰士 (世界版)	P-47 - 幻影戰士 (世界版)	Jaleco
p47j	P-47 - 自由戰士 (日版)	P-47 - 自由戰士 (日版)	Jaleco
tshingen	武田信玄 (日版, 日文)	武田信玄 (日版, 日文)	Jaleco
tshingna	武田信玄 (日版, 英文)	武田信玄 (日版, 英文)	Jaleco
iganinju	伊賀忍術傳 (日版)	伊賀忍術傳 (日版)	Jaleco
hachoo	破兆!	破兆!	Jaleco
jitsupro	實力!! 職業棒球 (日版)	實力!! 職業棒球 (日版)	Jaleco
stdragon	天聖龍	天聖龍	Jaleco
rodland	妖精物語 (世界版)	妖精物語 (世界版)	Jaleco
rodlandj	妖精物語 (日版)	妖精物語 (日版)	Jaleco
rodlndjb	妖精物語 (日版 bootleg)	妖精物語 (日版 bootleg)	Jaleco
avspirit	復仇精靈	復仇精靈	Jaleco
phantasm	復仇精靈 (日版)	復仇精靈 (日版)	Jaleco
edf	地球保衛戰	地球保衛戰	Jaleco
edfu	地球保衛戰 (North America)	地球保衛戰 (North America)	Jaleco
64street	64 街 (世界版)	64 街 (世界版)	Jaleco
64streej	64 街 (日版)	64 街 (日版)	Jaleco
chimerab	原生獸 (prototype)	原生獸 (prototype)	Jaleco
tetrisp	俄羅斯方塊 Plus	俄羅斯方塊 Plus	Jaleco / BPS
kirarast	流星雀士	流星雀士	Jaleco
tp2m32	俄羅斯方塊 Plus 2 (MegaSystem 32 Version)	俄羅斯方塊 Plus 2 (MegaSystem 32 Version)	Jaleco
f1superb	F1 超級戰鬥	F1 超級戰鬥	Jaleco
rabiolep	兔戰士 (日版)	兔戰士 (日版)	V-System Co.
rpunch	兔戰士 / Rabbit Punch (美版)	兔戰士 / Rabbit Punch (美版)	V-System Co. (Bally/Midway/Sente license)
svolley	超級排球 (日版)	超級排球 (日版)	V-System Co.
svolleyk	超級排球 (韓國版)	超級排球 (韓國版)	V-System Co.
svolleyu	超級排球 (美版)	超級排球 (美版)	V-System Co. (Data East license)
tail2nos	超級方程式	超級方程式	V-System Co.
sformula	超級方程式 (日版)	超級方程式 (日版)	V-System Co.
ojankoc	雀子俱樂部 (日版)	雀子俱樂部 (日版)	V-System Co.
ojankoy	雀子館 (日版)	雀子館 (日版)	V-System Co.
ojanko2	雀子館 2 番館 (日版)	雀子館 2 番館 (日版)	V-System Co.
ojankohs	雀子高中 (日版)	雀子高中 (日版)	V-System Co.
nekkyoku	列島縱斷 熱局雀士 - 東日本編 (日版)	列島縱斷 熱局雀士 - 東日本編 (日版)	Video System Co.
idolmj	偶像麻雀放送局 (日版)	偶像麻雀放送局 (日版)	System Service
mjnatsu	麻雀夏物語 (日版)	麻雀夏物語 (日版)	Video System Co.
natsuiro	麻雀夏物語 / 夏色麻雀 (日版)	麻雀夏物語 / 夏色麻雀 (日版)	Video System Co.
mfunclub	麻雀俱樂部 - 偶像最前線 (日版)	麻雀俱樂部 - 偶像最前線 (日版)	Video System Co.
daiyogen	麻雀大預言 (日版)	麻雀大預言 (日版)	Video System Co.
nmsengen	熱血麻雀宣言! AFTER 5 (日版)	熱血麻雀宣言! AFTER 5 (日版)	Video System Co.
fromance	偶像麻雀 最終羅曼史 (日版)	偶像麻雀 最終羅曼史 (日版)	Video System Co.
hatris	帶帽人 (日版)	帶帽人 (日版)	Video System Co.
pspikes	超級排球 '91 (世界版)	超級排球 '91 (世界版)	Video System Co.
pspikesk	超級排球 '91 (韓國版)	超級排球 '91 (韓國版)	Video System Co.
svolly91	超級排球 '91 (日版)	超級排球 '91 (日版)	Video System Co.
karatblz	鬥神光輝 / 鐵腿四少年 (世界版?)	鬥神光輝 / 鐵腿四少年 (世界版?)	Video System Co.
karatblu	鬥神光輝 / 鐵腿四少年 (美版)	鬥神光輝 / 鐵腿四少年 (美版)	Video System Co.
karatblj	鬥神光輝 / 鐵腿四少年 (日版)	鬥神光輝 / 鐵腿四少年 (日版)	Video System Co.
turbofrc	超級空軍	超級空軍	Video System Co.
aerofgt	音速戰機	音速戰機	Video System Co.
aerofgtb	音速戰機 (Turbo Force hardware set 1)	音速戰機 (Turbo Force hardware set 1)	Video System Co.
aerofgtc	音速戰機 (Turbo Force hardware set 2)	音速戰機 (Turbo Force hardware set 2)	Video System Co.
sonicwi	音速戰機 (日版)	音速戰機 (日版)	Video System Co.
suprslam	灌籃高手	灌籃高手	Banpresto / Toei Animation
fromanc2	對戰偶像麻雀 最終羅曼史 2 (日版)	對戰偶像麻雀 最終羅曼史 2 (日版)	Video System Co.
fromancr	對戰麻雀 最終羅曼史 R (日版)	對戰麻雀 最終羅曼史 R (日版)	Video System Co.
fromanc4	對戰麻雀 最終羅曼史 4 (日版)	對戰麻雀 最終羅曼史 4 (日版)	Video System Co.
samuraia	戰國 Ace / Samurai Aces (世界版)	戰國 Ace / Samurai Aces (世界版)	Psikyo
sngkace	戰國 Ace (日版)	戰國 Ace (日版)	Psikyo
gunbird	武裝飛鳥 (世界版)	武裝飛鳥 (世界版)	Psikyo
gunbirdk	武裝飛鳥 (韓國版)	武裝飛鳥 (韓國版)	Psikyo
gunbirdj	武裝飛鳥 (日版)	武裝飛鳥 (日版)	Psikyo
s1945	打擊者 1945	打擊者 1945	Psikyo
s1945a	打擊者 1945 (Alt)	打擊者 1945 (Alt)	Psikyo
s1945j	打擊者 1945 (日版)	打擊者 1945 (日版)	Psikyo
s1945jn	打擊者 1945 (日版, unprotected)	打擊者 1945 (日版, unprotected)	Psikyo
tengai	戰國之刃: Sengoku Ace Episode II	戰國之刃: Sengoku Ace Episode II	Psikyo
s1945ii	打擊者 1945 II	打擊者 1945 II	Psikyo
soldivid	太陽表決	太陽表決	Psikyo
daraku	墮落天使	墮落天使	Psikyo
gunbird2	武裝飛鳥 2	武裝飛鳥 2	Psikyo
s1945iii	打擊者 1945 III (世界版) / 打擊者 1999 (日版)	打擊者 1945 III (世界版) / 打擊者 1999 (日版)	Psikyo
biomtoy	生化玩具兵 (unprotected)	生化玩具兵 (unprotected)	Gaelco
airbustr	空中堡壘 (世界版)	空中堡壘 (世界版)	Kaneko (Namco license)
airbustj	空中堡壘 (日版)	空中堡壘 (日版)	Kaneko (Namco license)
galpanic	天蠶變 (set 1)	天蠶變 (set 1)	Kaneko
galpanib	天蠶變 (set 2)	天蠶變 (set 2)	Kaneko
galpania	天蠶變 (set 3)	天蠶變 (set 3)	Kaneko
galpani2	天蠶變 II (日版?)	天蠶變 II (日版?)	Kaneko
gpan2qiz	天蠶變 II - 問答版 (日版)	天蠶變 II - 問答版 (日版)	Kaneko
galpani3	天蠶變 3	天蠶變 3	Kaneko
berlwall	柏林圍牆 (set 1)	柏林圍牆 (set 1)	Kaneko
berlwalt	柏林圍牆 (set 2)	柏林圍牆 (set 2)	Kaneko
mgcrystl	魔法水晶 (世界版)	魔法水晶 (世界版)	Kaneko
mgcrystj	魔法水晶 (日版)	魔法水晶 (日版)	Kaneko (Atlus license)
blazeon	魂之光輝 (日版)	魂之光輝 (日版)	Atlus
bakubrkr	爆裂戰機	爆裂戰機	Kaneko
galpani4	天蠶變 4 (日版)	天蠶變 4 (日版)	Kaneko
galpanis	天蠶變 S - Extra Edition (日版)	天蠶變 S - Extra Edition (日版)	Kaneko
galpans2	天蠶變 S2 (日版)	天蠶變 S2 (日版)	Kaneko
senknow	線腦 (日版)	線腦 (日版)	Kaneko / Kouyousha
puzzloop	渦輪泡泡 (歐洲版)	渦輪泡泡 (歐洲版)	Mitchell
puzloopj	渦輪泡泡 (日版)	渦輪泡泡 (日版)	Mitchell
puzloopu	渦輪泡泡 (美版)	渦輪泡泡 (美版)	Mitchell
ryouran	對戰麻雀 乙女繚亂	對戰麻雀 乙女繚亂	Electro Design
teljan	Tel 雀	Tel 雀	Electro Design
hanaawas	花札 (Flower Matching)	花札 (Flower Matching)	Seta
srmp2	超真實麻雀 Part 2 (日版)	超真實麻雀 Part 2 (日版)	Seta
srmp3	超真實麻雀 Part 3 (日版)	超真實麻雀 Part 3 (日版)	Seta
mjyuugi	麻雀遊技 (日版 set 1)	麻雀遊技 (日版 set 1)	Visco
mjyuugia	麻雀遊技 (日版 set 2)	麻雀遊技 (日版 set 2)	Visco
tndrcade	特殊部隊 U.A.G. / Thundercade / Twin Formation	特殊部隊 U.A.G. / Thundercade / Twin Formation	[Seta] (Taito license)
tndrcadj	特殊部隊 U.A.G. (日版)	特殊部隊 U.A.G. (日版)	[Seta] (Taito license)
twineagl	雙鷹	雙鷹	Seta (Taito license)
downtown	目擊	目擊	Seta
downtowp	目擊 (prototype)	目擊 (prototype)	Seta
calibr50	口徑 50	口徑 50	Athena / Seta
metafox	沙漠之狐	沙漠之狐	Seta
umanclub	鹹蛋超人俱樂部	鹹蛋超人俱樂部	Tsuburaya Prod. / Banpresto
zingzip	真真急炮	真真急炮	Allumer + Tecmo
msgundam	機動戰士 	機動戰士 	Banpresto
msgunda1	機動戰士 (日版)	機動戰士 (日版)	Banpresto
daioh	大王	大王	Athena
wrofaero	空戰 - MEIOU 計劃	空戰 - MEIOU 計劃	Yang Cheng
kiwame	究極職業麻雀	究極職業麻雀	Athena
extdwnhl	極限滑降 (v1.5)	極限滑降 (v1.5)	Sammy Industries Japan
gundhara	銃彈嵐	銃彈嵐	Banpresto
gundamex	機動戰士 EX Revue	機動戰士 EX Revue	Banpresto
grdians	電精 / 電神魔傀 II	電精 / 電神魔傀 II	Banpresto
mj4simai	麻雀四姊妹 若草物語 (日版)	麻雀四姊妹 若草物語 (日版)	Maboroshi Ware
myangel	育嬰問答 - 親親小寶貝 (日版)	育嬰問答 - 親親小寶貝 (日版)	Namco
myangel2	育嬰問答 - 親親小寶貝 2 (日版)	育嬰問答 - 親親小寶貝 2 (日版)	Namco
srmp4	超真實麻雀 PIV (日版)	超真實麻雀 PIV (日版)	Seta
srmp4o	超真實麻雀 PIV (日版, older set)	超真實麻雀 PIV (日版, older set)	Seta
srmp7	超真實麻雀 P7 (日版)	超真實麻雀 P7 (日版)	Seta
vasara	婆裟羅	婆裟羅	Visco
vasara2	婆裟羅 2 (set 1)	婆裟羅 2 (set 1)	Visco
vasara2a	婆裟羅 2 (set 2)	婆裟羅 2 (set 2)	Visco
srmp5	超真實麻雀 P5	超真實麻雀 P5	Seta
powerins	豪血寺一族 (美版 bootleg) (set 1)	豪血寺一族 (美版 bootleg) (set 1)	Atlus
powerina	豪血寺一族 (美版 bootleg) (set 2)	豪血寺一族 (美版 bootleg) (set 2)	Atlus
ttmahjng	麻雀	麻雀	Taito
strnskil	鋸木王 / Strength & Skill	鋸木王 / Strength & Skill	Sun Electronics
guiness	鋸木王 (日版)	鋸木王 (日版)	Sun Electronics
shanghai	上海 (日版)	上海 (日版)	Sunsoft
shangha2	上海 II (日版)	上海 II (日版)	Sunsoft
shangha3	上海 III (日版)	上海 III (日版)	Sunsoft
bssoccer	街頭足球	街頭足球	SunA
uballoon	終極氣球	終極氣球	SunA
gundealr	美女槍手 (set 1)	美女槍手 (set 1)	Dooyong
gundeala	美女槍手 (set 2)	美女槍手 (set 2)	Dooyong
gundealt	美女槍手 (Tecmo)	美女槍手 (Tecmo)	Tecmo
lastday	末日危機 (set 1)	末日危機 (set 1)	Dooyong
lastdaya	末日危機 (set 2)	末日危機 (set 2)	Dooyong
gulfstrm	海灣風暴	海灣風暴	Dooyong
gulfstr2	海灣風暴 (Media Shoji)	海灣風暴 (Media Shoji)	Dooyong (Media Shoji license)
pollux	雙子座之星 (set 1)	雙子座之星 (set 1)	Dooyong
polluxa	雙子座之星 (set 2)	雙子座之星 (set 2)	Dooyong
bluehawk	鷹擊藍空	鷹擊藍空	Dooyong
bluehawn	鷹擊藍空 (NTC)	鷹擊藍空 (NTC)	[Dooyong] (NTC license)
galspnbl	少女彈珠台	少女彈珠台	Comad
fantasia	天蠶變幻想曲	天蠶變幻想曲	Comad & New Japan System
newfant	新天蠶變幻想曲	新天蠶變幻想曲	Comad & New Japan System
missw96	天蠶變 '96	天蠶變 '96	Comad
missmw96	天蠶變 '96 / Miss Mister World '96 Nude	天蠶變 '96 / Miss Mister World '96 Nude	Comad
fantsia2	天蠶變幻想曲 II	天蠶變幻想曲 II	Comad
wbeachvl	世界沙灘排球 (set 1)	世界沙灘排球 (set 1)	Playmark
wbeachv2	世界沙灘排球 (set 2)	世界沙灘排球 (set 2)	Playmark
natodef	北約防線	北約防線	Pacific Novelty
natodefa	北約防線 (alternate mazes)	北約防線 (alternate mazes)	Pacific Novelty
crzrally	瘋狂拉力	瘋狂拉力	Tecfri
karatour	空手道大賽	空手道大賽	Mitchell
ladykill	燃燒吧 Gonta!! / Lady Killer	燃燒吧 Gonta!! / Lady Killer	Yanyaka (Mitchell license)
moegonta	燃燒吧 Gonta!! (日版)	燃燒吧 Gonta!! (日版)	Yanyaka
pangpoms	魔法氣泡 Poms	魔法氣泡 Poms	Metro
pangpomm	魔法氣泡 Poms (Mitchell)	魔法氣泡 Poms (Mitchell)	Metro (Mitchell license)
poitto	魔法方塊	魔法方塊	Metro / Able Corp.
dharma	達摩道場	達摩道場	Metro
lastfort	牌砦	牌砦	Metro
lastfero	牌砦 (Erotic)	牌砦 (Erotic)	Metro
lastforg	牌砦 (德文)	牌砦 (德文)	Metro
toride2g	牌砦 II 復仇外傳 / 戰國智慧牌	牌砦 II 復仇外傳 / 戰國智慧牌	Metro
daitorid	大牌砦	大牌砦	Metro
dokyusei	同級生麻雀	同級生麻雀	Make Software / Elf / Media Trading
dokyusp	同級生麻雀 特別版	同級生麻雀 特別版	Make Software / Elf / Media Trading
3kokushi	三刻志 (日版)	三刻志 (日版)	Mitchell
gakusai	麻雀學園祭 (日版)	麻雀學園祭 (日版)	MakeSoft
gakusai2	麻雀學園祭 2 (日版)	麻雀學園祭 2 (日版)	MakeSoft
spcforce	太空武力	太空武力	Venture Line
spcforc2	太空武力 (set 2)	太空武力 (set 2)	Elcon (bootleg?)
meteor	太空武力 / Meteoroids	太空武力 / Meteoroids	Venture Line
pbancho	逆轉!! Puzzle 番長 (日版)	逆轉!! Puzzle 番長 (日版)	Fuuki
burglarx	夜盜 X	夜盜 X	Unico
silkroad	絲路傳說	絲路傳說	Unico
grdnstrm	戰神 守護風暴 (韓國版)	戰神 守護風暴 (韓國版)	Afega
hnayayoi	華彌生 (日版)	華彌生 (日版)	Dyna Electronics
hnfubuki	華吹雪 [BET] (日版)	華吹雪 [BET] (日版)	Dynax
tontonb	東東 [BET] (日版)	東東 [BET] (日版)	Dynax
hanamai	華之舞 (日版)	華之舞 (日版)	Dynax
hnkochou	華胡蝶 [BET] (日版)	華胡蝶 [BET] (日版)	Dynax
hnoridur	華折鶴 (日版)	華折鶴 (日版)	Dynax
jantouki	雀鬥記 (日版)	雀鬥記 (日版)	Dynax
7jigen	7 次元之妖精達 (日版)	7 次元之妖精達 (日版)	Dynax
quizchq	民國教育委員會 (Ver 1.00) (日版)	民國教育委員會 (Ver 1.00) (日版)	Nakanihon
quizchql	民國教育委員會 (Ver 1.23) (台灣版?)	民國教育委員會 (Ver 1.23) (台灣版?)	Nakanihon (Laxan license)
quiz365	問答 365 (日版)	問答 365 (日版)	Nakanihon
quiz365t	問答 365 (香港版 & 台灣版)	問答 365 (香港版 & 台灣版)	Nakanihon + Taito
rongrong	龍龍 (歐洲版)	龍龍 (歐洲版)	Nakanihon
rongrngg	龍龍 (德國版)	龍龍 (德國版)	Nakanihon
ddenlovr	黑白棋 Vol. 1 (香港版)	黑白棋 Vol. 1 (香港版)	Dynax
mjelctrn	電子基盤 (parts 2 & 4, 日版)	電子基盤 (parts 2 & 4, 日版)	Dynax
mjelct3	電子基盤 (parts 2 & 3, 日版)	電子基盤 (parts 2 & 3, 日版)	Dynax
mjelct3a	電子基盤 (parts 2 & 3, alt., 日版)	電子基盤 (parts 2 & 3, alt., 日版)	Dynax
nyny	拯救紐約	拯救紐約	Sigma Enterprises Inc.
nynyg	拯救紐約 (Gottlieb)	拯救紐約 (Gottlieb)	Sigma Enterprises Inc. (Gottlieb license)
arcadia	拯救紐約 / Waga Seishun no Arcadia	拯救紐約 / Waga Seishun no Arcadia	Sigma Enterprises Inc.
orlegend	西遊釋厄傳 (ver. 126)	西遊釋厄傳 (ver. 126)	IGS
orlegnde	西遊釋厄傳 (ver. 112)	西遊釋厄傳 (ver. 112)	IGS
orlegndc	西遊釋厄傳 (ver. 112, Chinese Board)	西遊釋厄傳 (ver. 112, Chinese Board)	IGS
orld111c	西遊釋厄傳 (ver. 111, Chinese Board)	西遊釋厄傳 (ver. 111, Chinese Board)	IGS
orld105k	西遊釋厄傳 (ver. 105, Korean Board)	西遊釋厄傳 (ver. 105, Korean Board)	IGS
drgw2	中國龍 II / 龍世界 II (ver. 110X, Export)	中國龍 II / 龍世界 II (ver. 110X, Export)	IGS
drgw2c	中國龍 II  (ver. 100C, 中國版)	中國龍 II  (ver. 100C, 中國版)	IGS
drgw3	中國龍 3 / 龍世界 3	中國龍 3 / 龍世界 3	IGS
drgw3k	中國龍 3 / 龍世界 3 (Korean Board)	中國龍 3 / 龍世界 3 (Korean Board)	IGS
kov	三國戰記 (ver. 117)	三國戰記 (ver. 117)	IGS
kovplus	三國戰記 Plus (ver. 119)	三國戰記 Plus (ver. 119)	IGS
kovplusa	三國戰記 Plus (alt ver. 119)	三國戰記 Plus (alt ver. 119)	IGS
kov115	三國戰記 (ver. 115)	三國戰記 (ver. 115)	IGS
kovj	三國戰記 Plus (ver. 100, Japanese Board)	三國戰記 Plus (ver. 100, Japanese Board)	IGS
kovsh	三國戰記 - 風雲再起 (ver. 322)	三國戰記 - 風雲再起 (ver. 322)	IGS
photoy2k	大家來找碴	大家來找碴	IGS
raf102j	大家來找碴 (ver. 102, Japan Board)	大家來找碴 (ver. 102, Japan Board)	IGS
mjkjidai	麻雀狂時代 (日版)	麻雀狂時代 (日版)	Sanritsu
kinst	殺手學堂 (v1.5d)	殺手學堂 (v1.5d)	Rare
kinst14	殺手學堂 (v1.4)	殺手學堂 (v1.4)	Rare
kinst13	殺手學堂 (v1.3)	殺手學堂 (v1.3)	Rare
kinstp	殺手學堂 (proto v4.7)	殺手學堂 (proto v4.7)	Rare
kinst2	殺手學堂 2 (v1.4)	殺手學堂 2 (v1.4)	Rare
kinst2k	殺手學堂 2 (v1.4k, upgrade kit)	殺手學堂 2 (v1.4k, upgrade kit)	Rare
kinst213	殺手學堂 2 (v1.3)	殺手學堂 2 (v1.3)	Rare
kinst211	殺手學堂 2 (v1.1)	殺手學堂 2 (v1.1)	Rare
kinst210	殺手學堂 2 (v1.0)	殺手學堂 2 (v1.0)	Rare
themj	麻將 / The Mah-jong (日版)	麻將 / The Mah-jong (日版)	Visco
hanaroku	花六	花六	Alba
hourouki	麻雀放浪記 Part 1 (日版)	麻雀放浪記 Part 1 (日版)	Home Data
mhgaiden	麻雀放浪記外傳 (日版)	麻雀放浪記外傳 (日版)	Home Data
mjhokite	麻雀放浪記 掟 (日版)	麻雀放浪記 掟 (日版)	Home Data
mrokumei	麻雀鹿鳴館 (日版)	麻雀鹿鳴館 (日版)	Home Data
reikaids	靈界導士 (日版)	靈界導士 (日版)	Home Data
mjkojink	麻雀 (個人教授) (日版)	麻雀 (個人教授) (日版)	Home Data
mjyougo	麻雀用語之基礎體力 (日版)	麻雀用語之基礎體力 (日版)	Home Data
jogakuen	麻雀女學園 (日版)	麻雀女學園 (日版)	Windom
chinhero	中華英雄	中華英雄	Taiyo
chinher2	中華英雄 (older)	中華英雄 (older)	Taiyo
shangkid	上海小子	上海小子	Taiyo (Data East license)
hiryuken	上海小子 / Hokuha Syourin Hiryu no Ken	上海小子 / Hokuha Syourin Hiryu no Ken	[Nihon Game] (Taito license)
spaceint	太空侵略者 / Space Intruder	太空侵略者 / Space Intruder	Shoei
exterm	滅殺者	滅殺者	Gottlieb / Premier Technology
othldrby	賽馬大會 (日版)	賽馬大會 (日版)	Sunwise
rabbit	羅媚斗	羅媚斗	Electronic Arts / Aorn
